Poker Hand #TM4181621601: Tournament #187165250, Mini Hypersonic $2.50 Hold'em No Limit - Level45(100,000/200,000) - 2025/02/03 19:04:48
Table '94' 7-max Seat #6 is the button
Seat 1: Hero (7,695,672 in chips)
Seat 6: 9feeaa16 (3,354,328 in chips)
Hero: posts the ante 30,000
9feeaa16: posts the ante 30,000
9feeaa16: posts small blind 100,000
Hero: posts big blind 200,000
*** HOLE CARDS ***
Dealt to Hero [9d 9s]
Dealt to 9feeaa16 
9feeaa16: raises 3,124,328 to 3,324,328 and is all-in
Hero: calls 3,124,328
9feeaa16: shows [7d 5s]
Hero: shows [9d 9s]
*** FLOP *** [2h Tc Kh]
*** TURN *** [2h Tc Kh] [Ac]
*** RIVER *** [2h Tc Kh Ac] [Ad]
*** SHOWDOWN ***
Hero collected 6,708,656 from pot
*** SUMMARY ***
Total pot 6,708,656 | Rake 0 | Jackpot 0 | Bingo 0 | Fortune 0 | Tax 0
Board [2h Tc Kh Ac Ad]
Seat 1: Hero (big blind) showed [9d 9s] and won (6,708,656) with Pair of Aces and Pair of Nines
Seat 6: 9feeaa16 (small blind) showed [7d 5s] and lost with Pair of Aces


Poker Hand #TM4181621588: Tournament #187165250, Mini Hypersonic $2.50 Hold'em No Limit - Level45(100,000/200,000) - 2025/02/03 19:04:30
Table '94' 7-max Seat #1 is the button
Seat 1: Hero (7,925,672 in chips)
Seat 6: 9feeaa16 (3,124,328 in chips)
Hero: posts the ante 30,000
9feeaa16: posts the ante 30,000
Hero: posts small blind 100,000
9feeaa16: posts big blind 200,000
*** HOLE CARDS ***
Dealt to Hero [4c 5h]
Dealt to 9feeaa16 
Hero: calls 100,000
9feeaa16: raises 500,000 to 700,000
Hero: folds
Uncalled bet (500,000) returned to 9feeaa16
*** SHOWDOWN ***
9feeaa16 collected 460,000 from pot
*** SUMMARY ***
Total pot 460,000 | Rake 0 | Jackpot 0 | Bingo 0 | Fortune 0 | Tax 0
Seat 1: Hero (small blind) folded before Flop
Seat 6: 9feeaa16 (big blind) collected (460,000)


Poker Hand #TM4181621560: Tournament #187165250, Mini Hypersonic $2.50 Hold'em No Limit - Level44(80,000/160,000) - 2025/02/03 19:03:41
Table '94' 7-max Seat #6 is the button
Seat 1: Hero (3,962,836 in chips)
Seat 6: 9feeaa16 (7,087,164 in chips)
Hero: posts the ante 25,000
9feeaa16: posts the ante 25,000
9feeaa16: posts small blind 80,000
Hero: posts big blind 160,000
*** HOLE CARDS ***
Dealt to Hero [Qs Ad]
Dealt to 9feeaa16 
9feeaa16: raises 160,000 to 320,000
Hero: raises 480,000 to 800,000
9feeaa16: raises 544,500 to 1,344,500
Hero: raises 2,593,336 to 3,937,836 and is all-in
9feeaa16: calls 2,593,336
Hero: shows [Qs Ad]
9feeaa16: shows [Jd 8h]
*** FLOP *** [4c 6c 7h]
*** TURN *** [4c 6c 7h] [Qd]
*** RIVER *** [4c 6c 7h Qd] [9s]
*** SHOWDOWN ***
Hero collected 7,925,672 from pot
*** SUMMARY ***
Total pot 7,925,672 | Rake 0 | Jackpot 0 | Bingo 0 | Fortune 0 | Tax 0
Board [4c 6c 7h Qd 9s]
Seat 1: Hero (big blind) showed [Qs Ad] and won (7,925,672) with Pair of Queens
Seat 6: 9feeaa16 (small blind) showed [Jd 8h] and lost with Queen-High


Poker Hand #TM4181621544: Tournament #187165250, Mini Hypersonic $2.50 Hold'em No Limit - Level44(80,000/160,000) - 2025/02/03 19:03:16
Table '94' 7-max Seat #1 is the button
Seat 1: Hero (4,147,836 in chips)
Seat 6: 9feeaa16 (6,902,164 in chips)
Hero: posts the ante 25,000
9feeaa16: posts the ante 25,000
Hero: posts small blind 80,000
9feeaa16: posts big blind 160,000
*** HOLE CARDS ***
Dealt to Hero [Qd 6d]
Dealt to 9feeaa16 
Hero: calls 80,000
9feeaa16: checks
*** FLOP *** [2s Jh Kh]
9feeaa16: bets 277,500
Hero: folds
Uncalled bet (277,500) returned to 9feeaa16
*** SHOWDOWN ***
9feeaa16 collected 370,000 from pot
*** SUMMARY ***
Total pot 370,000 | Rake 0 | Jackpot 0 | Bingo 0 | Fortune 0 | Tax 0
Board [2s Jh Kh]
Seat 1: Hero (small blind) folded on the Flop
Seat 6: 9feeaa16 (big blind) won (370,000)


Poker Hand #TM4181621536: Tournament #187165250, Mini Hypersonic $2.50 Hold'em No Limit - Level44(80,000/160,000) - 2025/02/03 19:02:59
Table '94' 7-max Seat #6 is the button
Seat 1: Hero (3,962,836 in chips)
Seat 6: 9feeaa16 (7,087,164 in chips)
Hero: posts the ante 25,000
9feeaa16: posts the ante 25,000
9feeaa16: posts small blind 80,000
Hero: posts big blind 160,000
*** HOLE CARDS ***
Dealt to Hero [6c 4d]
Dealt to 9feeaa16 
9feeaa16: calls 80,000
Hero: raises 320,000 to 480,000
9feeaa16: folds
Uncalled bet (320,000) returned to Hero
*** SHOWDOWN ***
Hero collected 370,000 from pot
*** SUMMARY ***
Total pot 370,000 | Rake 0 | Jackpot 0 | Bingo 0 | Fortune 0 | Tax 0
Seat 1: Hero (big blind) collected (370,000)
Seat 6: 9feeaa16 (small blind) folded before Flop


Poker Hand #TM4181621522: Tournament #187165250, Mini Hypersonic $2.50 Hold'em No Limit - Level44(80,000/160,000) - 2025/02/03 19:02:34
Table '94' 7-max Seat #1 is the button
Seat 1: Hero (4,307,836 in chips)
Seat 6: 9feeaa16 (6,742,164 in chips)
Hero: posts the ante 25,000
9feeaa16: posts the ante 25,000
Hero: posts small blind 80,000
9feeaa16: posts big blind 160,000
*** HOLE CARDS ***
Dealt to Hero [6c 4c]
Dealt to 9feeaa16 
Hero: calls 80,000
9feeaa16: checks
*** FLOP *** [3h 2h Qh]
9feeaa16: checks
Hero: bets 160,000
9feeaa16: raises 345,000 to 505,000
Hero: folds
Uncalled bet (345,000) returned to 9feeaa16
*** SHOWDOWN ***
9feeaa16 collected 690,000 from pot
*** SUMMARY ***
Total pot 690,000 | Rake 0 | Jackpot 0 | Bingo 0 | Fortune 0 | Tax 0
Board [3h 2h Qh]
Seat 1: Hero (small blind) folded on the Flop
Seat 6: 9feeaa16 (big blind) won (690,000)


Poker Hand #TM4181621517: Tournament #187165250, Mini Hypersonic $2.50 Hold'em No Limit - Level44(80,000/160,000) - 2025/02/03 19:02:21
Table '94' 7-max Seat #6 is the button
Seat 1: Hero (4,492,836 in chips)
Seat 6: 9feeaa16 (6,557,164 in chips)
Hero: posts the ante 25,000
9feeaa16: posts the ante 25,000
9feeaa16: posts small blind 80,000
Hero: posts big blind 160,000
*** HOLE CARDS ***
Dealt to Hero [Jh 7c]
Dealt to 9feeaa16 
9feeaa16: raises 6,372,164 to 6,532,164 and is all-in
Hero: folds
Uncalled bet (6,372,164) returned to 9feeaa16
*** SHOWDOWN ***
9feeaa16 collected 370,000 from pot
*** SUMMARY ***
Total pot 370,000 | Rake 0 | Jackpot 0 | Bingo 0 | Fortune 0 | Tax 0
Seat 1: Hero (big blind) folded before Flop
Seat 6: 9feeaa16 (small blind) collected (370,000)


Poker Hand #TM4181621509: Tournament #187165250, Mini Hypersonic $2.50 Hold'em No Limit - Level44(80,000/160,000) - 2025/02/03 19:02:08
Table '94' 7-max Seat #1 is the button
Seat 1: Hero (4,677,836 in chips)
Seat 6: 9feeaa16 (6,372,164 in chips)
Hero: posts the ante 25,000
9feeaa16: posts the ante 25,000
Hero: posts small blind 80,000
9feeaa16: posts big blind 160,000
*** HOLE CARDS ***
Dealt to Hero [9c 7c]
Dealt to 9feeaa16 
Hero: calls 80,000
9feeaa16: raises 6,187,164 to 6,347,164 and is all-in
Hero: folds
Uncalled bet (6,187,164) returned to 9feeaa16
*** SHOWDOWN ***
9feeaa16 collected 370,000 from pot
*** SUMMARY ***
Total pot 370,000 | Rake 0 | Jackpot 0 | Bingo 0 | Fortune 0 | Tax 0
Seat 1: Hero (small blind) folded before Flop
Seat 6: 9feeaa16 (big blind) collected (370,000)


Poker Hand #TM4181621506: Tournament #187165250, Mini Hypersonic $2.50 Hold'em No Limit - Level44(80,000/160,000) - 2025/02/03 19:01:59
Table '94' 7-max Seat #6 is the button
Seat 1: Hero (4,572,836 in chips)
Seat 6: 9feeaa16 (6,477,164 in chips)
Hero: posts the ante 25,000
9feeaa16: posts the ante 25,000
9feeaa16: posts small blind 80,000
Hero: posts big blind 160,000
*** HOLE CARDS ***
Dealt to Hero [Jh 8d]
Dealt to 9feeaa16 
9feeaa16: folds
Uncalled bet (80,000) returned to Hero
*** SHOWDOWN ***
Hero collected 210,000 from pot
*** SUMMARY ***
Total pot 210,000 | Rake 0 | Jackpot 0 | Bingo 0 | Fortune 0 | Tax 0
Seat 1: Hero (big blind) collected (210,000)
Seat 6: 9feeaa16 (small blind) folded before Flop


Poker Hand #TM4181621484: Tournament #187165250, Mini Hypersonic $2.50 Hold'em No Limit - Level44(80,000/160,000) - 2025/02/03 19:01:36
Table '94' 7-max Seat #1 is the button
Seat 1: Hero (4,387,836 in chips)
Seat 6: 9feeaa16 (6,662,164 in chips)
Hero: posts the ante 25,000
9feeaa16: posts the ante 25,000
Hero: posts small blind 80,000
9feeaa16: posts big blind 160,000
*** HOLE CARDS ***
Dealt to Hero [3h 6h]
Dealt to 9feeaa16 
Hero: calls 80,000
9feeaa16: checks
*** FLOP *** [3d 9c 3s]
9feeaa16: checks
Hero: bets 320,000
9feeaa16: folds
Uncalled bet (320,000) returned to Hero
*** SHOWDOWN ***
Hero collected 370,000 from pot
*** SUMMARY ***
Total pot 370,000 | Rake 0 | Jackpot 0 | Bingo 0 | Fortune 0 | Tax 0
Board [3d 9c 3s]
Seat 1: Hero (small blind) won (370,000)
Seat 6: 9feeaa16 (big blind) folded on the Flop


Poker Hand #TM4181621477: Tournament #187165250, Mini Hypersonic $2.50 Hold'em No Limit - Level44(80,000/160,000) - 2025/02/03 19:01:23
Table '94' 7-max Seat #6 is the button
Seat 1: Hero (4,282,836 in chips)
Seat 6: 9feeaa16 (6,767,164 in chips)
Hero: posts the ante 25,000
9feeaa16: posts the ante 25,000
9feeaa16: posts small blind 80,000
Hero: posts big blind 160,000
*** HOLE CARDS ***
Dealt to Hero [8s 2s]
Dealt to 9feeaa16 
9feeaa16: folds
Uncalled bet (80,000) returned to Hero
*** SHOWDOWN ***
Hero collected 210,000 from pot
*** SUMMARY ***
Total pot 210,000 | Rake 0 | Jackpot 0 | Bingo 0 | Fortune 0 | Tax 0
Seat 1: Hero (big blind) collected (210,000)
Seat 6: 9feeaa16 (small blind) folded before Flop


Poker Hand #TM4181621474: Tournament #187165250, Mini Hypersonic $2.50 Hold'em No Limit - Level44(80,000/160,000) - 2025/02/03 19:01:09
Table '94' 7-max Seat #1 is the button
Seat 1: Hero (4,467,836 in chips)
Seat 6: 9feeaa16 (6,582,164 in chips)
Hero: posts the ante 25,000
9feeaa16: posts the ante 25,000
Hero: posts small blind 80,000
9feeaa16: posts big blind 160,000
*** HOLE CARDS ***
Dealt to Hero [8h 3h]
Dealt to 9feeaa16 
Hero: calls 80,000
9feeaa16: raises 6,397,164 to 6,557,164 and is all-in
Hero: folds
Uncalled bet (6,397,164) returned to 9feeaa16
*** SHOWDOWN ***
9feeaa16 collected 370,000 from pot
*** SUMMARY ***
Total pot 370,000 | Rake 0 | Jackpot 0 | Bingo 0 | Fortune 0 | Tax 0
Seat 1: Hero (small blind) folded before Flop
Seat 6: 9feeaa16 (big blind) collected (370,000)


Poker Hand #TM4181621471: Tournament #187165250, Mini Hypersonic $2.50 Hold'em No Limit - Level44(80,000/160,000) - 2025/02/03 19:00:55
Table '94' 7-max Seat #6 is the button
Seat 1: Hero (4,362,836 in chips)
Seat 6: 9feeaa16 (6,687,164 in chips)
Hero: posts the ante 25,000
9feeaa16: posts the ante 25,000
9feeaa16: posts small blind 80,000
Hero: posts big blind 160,000
*** HOLE CARDS ***
Dealt to Hero [Ts 7s]
Dealt to 9feeaa16 
9feeaa16: folds
Uncalled bet (80,000) returned to Hero
*** SHOWDOWN ***
Hero collected 210,000 from pot
*** SUMMARY ***
Total pot 210,000 | Rake 0 | Jackpot 0 | Bingo 0 | Fortune 0 | Tax 0
Seat 1: Hero (big blind) collected (210,000)
Seat 6: 9feeaa16 (small blind) folded before Flop


Poker Hand #TM4181621469: Tournament #187165250, Mini Hypersonic $2.50 Hold'em No Limit - Level44(80,000/160,000) - 2025/02/03 19:00:41
Table '94' 7-max Seat #1 is the button
Seat 1: Hero (4,867,836 in chips)
Seat 6: 9feeaa16 (6,182,164 in chips)
Hero: posts the ante 25,000
9feeaa16: posts the ante 25,000
Hero: posts small blind 80,000
9feeaa16: posts big blind 160,000
*** HOLE CARDS ***
Dealt to Hero [8h 2d]
Dealt to 9feeaa16 
Hero: raises 320,000 to 480,000
9feeaa16: raises 5,677,164 to 6,157,164 and is all-in
Hero: folds
Uncalled bet (5,677,164) returned to 9feeaa16
*** SHOWDOWN ***
9feeaa16 collected 1,010,000 from pot
*** SUMMARY ***
Total pot 1,010,000 | Rake 0 | Jackpot 0 | Bingo 0 | Fortune 0 | Tax 0
Seat 1: Hero (small blind) folded before Flop
Seat 6: 9feeaa16 (big blind) collected (1,010,000)


Poker Hand #TM4181621468: Tournament #187165250, Mini Hypersonic $2.50 Hold'em No Limit - Level44(80,000/160,000) - 2025/02/03 19:00:32
Table '94' 7-max Seat #6 is the button
Seat 1: Hero (4,762,836 in chips)
Seat 6: 9feeaa16 (6,287,164 in chips)
Hero: posts the ante 25,000
9feeaa16: posts the ante 25,000
9feeaa16: posts small blind 80,000
Hero: posts big blind 160,000
*** HOLE CARDS ***
Dealt to Hero [9h 9s]
Dealt to 9feeaa16 
9feeaa16: folds
Uncalled bet (80,000) returned to Hero
*** SHOWDOWN ***
Hero collected 210,000 from pot
*** SUMMARY ***
Total pot 210,000 | Rake 0 | Jackpot 0 | Bingo 0 | Fortune 0 | Tax 0
Seat 1: Hero (big blind) collected (210,000)
Seat 6: 9feeaa16 (small blind) folded before Flop


Poker Hand #TM4181621466: Tournament #187165250, Mini Hypersonic $2.50 Hold'em No Limit - Level44(80,000/160,000) - 2025/02/03 19:00:16
Table '94' 7-max Seat #1 is the button
Seat 1: Hero (4,577,836 in chips)
Seat 6: 9feeaa16 (6,472,164 in chips)
Hero: posts the ante 25,000
9feeaa16: posts the ante 25,000
Hero: posts small blind 80,000
9feeaa16: posts big blind 160,000
*** HOLE CARDS ***
Dealt to Hero [8c 9c]
Dealt to 9feeaa16 
Hero: raises 320,000 to 480,000
9feeaa16: folds
Uncalled bet (320,000) returned to Hero
*** SHOWDOWN ***
Hero collected 370,000 from pot
*** SUMMARY ***
Total pot 370,000 | Rake 0 | Jackpot 0 | Bingo 0 | Fortune 0 | Tax 0
Seat 1: Hero (small blind) collected (370,000)
Seat 6: 9feeaa16 (big blind) folded before Flop


Poker Hand #TM4181621463: Tournament #187165250, Mini Hypersonic $2.50 Hold'em No Limit - Level44(80,000/160,000) - 2025/02/03 19:00:05
Table '94' 7-max Seat #6 is the button
Seat 1: Hero (4,472,836 in chips)
Seat 6: 9feeaa16 (6,577,164 in chips)
Hero: posts the ante 25,000
9feeaa16: posts the ante 25,000
9feeaa16: posts small blind 80,000
Hero: posts big blind 160,000
*** HOLE CARDS ***
Dealt to Hero [Qd 3h]
Dealt to 9feeaa16 
9feeaa16: folds
Uncalled bet (80,000) returned to Hero
*** SHOWDOWN ***
Hero collected 210,000 from pot
*** SUMMARY ***
Total pot 210,000 | Rake 0 | Jackpot 0 | Bingo 0 | Fortune 0 | Tax 0
Seat 1: Hero (big blind) collected (210,000)
Seat 6: 9feeaa16 (small blind) folded before Flop


Poker Hand #TM4181621446: Tournament #187165250, Mini Hypersonic $2.50 Hold'em No Limit - Level43(70,000/140,000) - 2025/02/03 18:54:40
Table '94' 7-max Seat #1 is the button
Seat 1: Hero (4,312,836 in chips)
Seat 6: 9feeaa16 (6,737,164 in chips)
Hero: posts the ante 20,000
9feeaa16: posts the ante 20,000
Hero: posts small blind 70,000
9feeaa16: posts big blind 140,000
*** HOLE CARDS ***
Dealt to Hero [Jh 7c]
Dealt to 9feeaa16 
Hero: calls 70,000
9feeaa16: checks
*** FLOP *** [2s 5d 9s]
9feeaa16: checks
Hero: checks
*** TURN *** [2s 5d 9s] [2c]
9feeaa16: checks
Hero: bets 280,000
9feeaa16: folds
Uncalled bet (280,000) returned to Hero
*** SHOWDOWN ***
Hero collected 320,000 from pot
*** SUMMARY ***
Total pot 320,000 | Rake 0 | Jackpot 0 | Bingo 0 | Fortune 0 | Tax 0
Board [2s 5d 9s 2c]
Seat 1: Hero (small blind) won (320,000)
Seat 6: 9feeaa16 (big blind) folded on the Turn


Poker Hand #TM4181621433: Tournament #187165250, Mini Hypersonic $2.50 Hold'em No Limit - Level43(70,000/140,000) - 2025/02/03 18:54:26
Table '94' 7-max Seat #6 is the button
Seat 1: Hero (4,472,836 in chips)
Seat 6: 9feeaa16 (6,577,164 in chips)
Hero: posts the ante 20,000
9feeaa16: posts the ante 20,000
9feeaa16: posts small blind 70,000
Hero: posts big blind 140,000
*** HOLE CARDS ***
Dealt to Hero [6h 7c]
Dealt to 9feeaa16 
9feeaa16: raises 6,417,164 to 6,557,164 and is all-in
Hero: folds
Uncalled bet (6,417,164) returned to 9feeaa16
*** SHOWDOWN ***
9feeaa16 collected 320,000 from pot
*** SUMMARY ***
Total pot 320,000 | Rake 0 | Jackpot 0 | Bingo 0 | Fortune 0 | Tax 0
Seat 1: Hero (big blind) folded before Flop
Seat 6: 9feeaa16 (small blind) collected (320,000)


Poker Hand #TM4181621415: Tournament #187165250, Mini Hypersonic $2.50 Hold'em No Limit - Level43(70,000/140,000) - 2025/02/03 18:53:59
Table '94' 7-max Seat #3 is the button
Seat 1: Hero (4,632,836 in chips)
Seat 3: e393edee (2,056,628 in chips)
Seat 6: 9feeaa16 (4,360,536 in chips)
Hero: posts the ante 20,000
e393edee: posts the ante 20,000
9feeaa16: posts the ante 20,000
9feeaa16: posts small blind 70,000
Hero: posts big blind 140,000
*** HOLE CARDS ***
Dealt to Hero [8c 4c]
Dealt to e393edee 
Dealt to 9feeaa16 
e393edee: raises 1,896,628 to 2,036,628 and is all-in
9feeaa16: raises 2,303,908 to 4,340,536 and is all-in
Hero: folds
Uncalled bet (2,303,908) returned to 9feeaa16
9feeaa16: shows [Ac As]
e393edee: shows [9h Ah]
*** FLOP *** [Qc 7c 3s]
*** TURN *** [Qc 7c 3s] [4h]
*** RIVER *** [Qc 7c 3s 4h] [Kc]
*** SHOWDOWN ***
9feeaa16 collected 4,273,256 from pot
*** SUMMARY ***
Total pot 4,273,256 | Rake 0 | Jackpot 0 | Bingo 0 | Fortune 0 | Tax 0
Board [Qc 7c 3s 4h Kc]
Seat 1: Hero (big blind) folded before Flop
Seat 3: e393edee (button) showed [9h Ah] and lost with Ace-High
Seat 6: 9feeaa16 (small blind) showed [Ac As] and won (4,273,256) with Pair of Aces


Poker Hand #TM4181621395: Tournament #187165250, Mini Hypersonic $2.50 Hold'em No Limit - Level43(70,000/140,000) - 2025/02/03 18:53:31
Table '94' 7-max Seat #1 is the button
Seat 1: Hero (4,652,836 in chips)
Seat 3: e393edee (1,018,314 in chips)
Seat 6: 9feeaa16 (5,378,850 in chips)
Hero: posts the ante 20,000
e393edee: posts the ante 20,000
9feeaa16: posts the ante 20,000
e393edee: posts small blind 70,000
9feeaa16: posts big blind 140,000
*** HOLE CARDS ***
Dealt to Hero [Jd 2d]
Dealt to e393edee 
Dealt to 9feeaa16 
Hero: folds
e393edee: raises 858,314 to 998,314 and is all-in
9feeaa16: calls 858,314
e393edee: shows [9h Js]
9feeaa16: shows [7c Ac]
*** FLOP *** [4d 3s 9d]
*** TURN *** [4d 3s 9d] [Jc]
*** RIVER *** [4d 3s 9d Jc] [Tc]
Hero: shows [Jd] (Pair of Jacks)
*** SHOWDOWN ***
e393edee collected 2,056,628 from pot
*** SUMMARY ***
Total pot 2,056,628 | Rake 0 | Jackpot 0 | Bingo 0 | Fortune 0 | Tax 0
Board [4d 3s 9d Jc Tc]
Seat 1: Hero (button) folded before Flop
Seat 3: e393edee (small blind) showed [9h Js] and won (2,056,628) with Pair of Jacks and Pair of Nines
Seat 6: 9feeaa16 (big blind) showed [7c Ac] and lost with Ace-High


Poker Hand #TM4181621384: Tournament #187165250, Mini Hypersonic $2.50 Hold'em No Limit - Level43(70,000/140,000) - 2025/02/03 18:53:16
Table '94' 7-max Seat #6 is the button
Seat 1: Hero (4,742,836 in chips)
Seat 3: e393edee (1,178,314 in chips)
Seat 6: 9feeaa16 (5,128,850 in chips)
Hero: posts the ante 20,000
e393edee: posts the ante 20,000
9feeaa16: posts the ante 20,000
Hero: posts small blind 70,000
e393edee: posts big blind 140,000
*** HOLE CARDS ***
Dealt to Hero [Th Qs]
Dealt to e393edee 
Dealt to 9feeaa16 
9feeaa16: raises 4,968,850 to 5,108,850 and is all-in
Hero: folds
e393edee: folds
Uncalled bet (4,968,850) returned to 9feeaa16
*** SHOWDOWN ***
9feeaa16 collected 410,000 from pot
*** SUMMARY ***
Total pot 410,000 | Rake 0 | Jackpot 0 | Bingo 0 | Fortune 0 | Tax 0
Seat 1: Hero (small blind) folded before Flop
Seat 3: e393edee (big blind) folded before Flop
Seat 6: 9feeaa16 (button) collected (410,000)


Poker Hand #TM4181621378: Tournament #187165250, Mini Hypersonic $2.50 Hold'em No Limit - Level43(70,000/140,000) - 2025/02/03 18:52:56
Table '94' 7-max Seat #3 is the button
Seat 1: Hero (4,902,836 in chips)
Seat 3: e393edee (928,314 in chips)
Seat 6: 9feeaa16 (5,218,850 in chips)
Hero: posts the ante 20,000
e393edee: posts the ante 20,000
9feeaa16: posts the ante 20,000
9feeaa16: posts small blind 70,000
Hero: posts big blind 140,000
*** HOLE CARDS ***
Dealt to Hero [3d As]
Dealt to e393edee 
Dealt to 9feeaa16 
e393edee: raises 768,314 to 908,314 and is all-in
9feeaa16: folds
Hero: folds
Uncalled bet (768,314) returned to e393edee
*** SHOWDOWN ***
e393edee collected 410,000 from pot
*** SUMMARY ***
Total pot 410,000 | Rake 0 | Jackpot 0 | Bingo 0 | Fortune 0 | Tax 0
Seat 1: Hero (big blind) folded before Flop
Seat 3: e393edee (button) collected (410,000)
Seat 6: 9feeaa16 (small blind) folded before Flop


Poker Hand #TM4181621368: Tournament #187165250, Mini Hypersonic $2.50 Hold'em No Limit - Level43(70,000/140,000) - 2025/02/03 18:52:42
Table '94' 7-max Seat #1 is the button
Seat 1: Hero (4,922,836 in chips)
Seat 3: e393edee (748,314 in chips)
Seat 6: 9feeaa16 (5,378,850 in chips)
Hero: posts the ante 20,000
e393edee: posts the ante 20,000
9feeaa16: posts the ante 20,000
e393edee: posts small blind 70,000
9feeaa16: posts big blind 140,000
*** HOLE CARDS ***
Dealt to Hero [4h 6s]
Dealt to e393edee 
Dealt to 9feeaa16 
Hero: folds
e393edee: raises 588,314 to 728,314 and is all-in
9feeaa16: folds
Uncalled bet (588,314) returned to e393edee
*** SHOWDOWN ***
e393edee collected 340,000 from pot
*** SUMMARY ***
Total pot 340,000 | Rake 0 | Jackpot 0 | Bingo 0 | Fortune 0 | Tax 0
Seat 1: Hero (button) folded before Flop
Seat 3: e393edee (small blind) collected (340,000)
Seat 6: 9feeaa16 (big blind) folded before Flop


Poker Hand #TM4181621354: Tournament #187165250, Mini Hypersonic $2.50 Hold'em No Limit - Level43(70,000/140,000) - 2025/02/03 18:52:28
Table '94' 7-max Seat #6 is the button
Seat 1: Hero (4,742,836 in chips)
Seat 3: e393edee (908,314 in chips)
Seat 6: 9feeaa16 (5,398,850 in chips)
Hero: posts the ante 20,000
e393edee: posts the ante 20,000
9feeaa16: posts the ante 20,000
Hero: posts small blind 70,000
e393edee: posts big blind 140,000
*** HOLE CARDS ***
Dealt to Hero [9d 4h]
Dealt to e393edee 
Dealt to 9feeaa16 
9feeaa16: folds
Hero: raises 1,820,000 to 1,960,000
e393edee: folds
Uncalled bet (1,820,000) returned to Hero
*** SHOWDOWN ***
Hero collected 340,000 from pot
*** SUMMARY ***
Total pot 340,000 | Rake 0 | Jackpot 0 | Bingo 0 | Fortune 0 | Tax 0
Seat 1: Hero (small blind) collected (340,000)
Seat 3: e393edee (big blind) folded before Flop
Seat 6: 9feeaa16 (button) folded before Flop


Poker Hand #TM4181621343: Tournament #187165250, Mini Hypersonic $2.50 Hold'em No Limit - Level43(70,000/140,000) - 2025/02/03 18:52:17
Table '94' 7-max Seat #3 is the button
Seat 1: Hero (4,632,836 in chips)
Seat 3: e393edee (928,314 in chips)
Seat 6: 9feeaa16 (5,488,850 in chips)
Hero: posts the ante 20,000
e393edee: posts the ante 20,000
9feeaa16: posts the ante 20,000
9feeaa16: posts small blind 70,000
Hero: posts big blind 140,000
*** HOLE CARDS ***
Dealt to Hero [7d 2d]
Dealt to e393edee 
Dealt to 9feeaa16 
e393edee: folds
9feeaa16: folds
Uncalled bet (70,000) returned to Hero
*** SHOWDOWN ***
Hero collected 200,000 from pot
*** SUMMARY ***
Total pot 200,000 | Rake 0 | Jackpot 0 | Bingo 0 | Fortune 0 | Tax 0
Seat 1: Hero (big blind) collected (200,000)
Seat 3: e393edee (button) folded before Flop
Seat 6: 9feeaa16 (small blind) folded before Flop


Poker Hand #TM4181621337: Tournament #187165250, Mini Hypersonic $2.50 Hold'em No Limit - Level43(70,000/140,000) - 2025/02/03 18:52:04
Table '94' 7-max Seat #1 is the button
Seat 1: Hero (4,652,836 in chips)
Seat 3: e393edee (1,018,314 in chips)
Seat 6: 9feeaa16 (5,378,850 in chips)
Hero: posts the ante 20,000
e393edee: posts the ante 20,000
9feeaa16: posts the ante 20,000
e393edee: posts small blind 70,000
9feeaa16: posts big blind 140,000
*** HOLE CARDS ***
Dealt to Hero [4h Kd]
Dealt to e393edee 
Dealt to 9feeaa16 
Hero: folds
e393edee: folds
Uncalled bet (70,000) returned to 9feeaa16
*** SHOWDOWN ***
9feeaa16 collected 200,000 from pot
*** SUMMARY ***
Total pot 200,000 | Rake 0 | Jackpot 0 | Bingo 0 | Fortune 0 | Tax 0
Seat 1: Hero (button) folded before Flop
Seat 3: e393edee (small blind) folded before Flop
Seat 6: 9feeaa16 (big blind) collected (200,000)


Poker Hand #TM4181621325: Tournament #187165250, Mini Hypersonic $2.50 Hold'em No Limit - Level43(70,000/140,000) - 2025/02/03 18:51:50
Table '94' 7-max Seat #6 is the button
Seat 1: Hero (4,472,836 in chips)
Seat 3: e393edee (1,178,314 in chips)
Seat 6: 9feeaa16 (5,398,850 in chips)
Hero: posts the ante 20,000
e393edee: posts the ante 20,000
9feeaa16: posts the ante 20,000
Hero: posts small blind 70,000
e393edee: posts big blind 140,000
*** HOLE CARDS ***
Dealt to Hero [5h Kh]
Dealt to e393edee 
Dealt to 9feeaa16 
9feeaa16: folds
Hero: raises 1,260,000 to 1,400,000
e393edee: folds
Uncalled bet (1,260,000) returned to Hero
*** SHOWDOWN ***
Hero collected 340,000 from pot
*** SUMMARY ***
Total pot 340,000 | Rake 0 | Jackpot 0 | Bingo 0 | Fortune 0 | Tax 0
Seat 1: Hero (small blind) collected (340,000)
Seat 3: e393edee (big blind) folded before Flop
Seat 6: 9feeaa16 (button) folded before Flop


Poker Hand #TM4181621300: Tournament #187165250, Mini Hypersonic $2.50 Hold'em No Limit - Level43(70,000/140,000) - 2025/02/03 18:51:11
Table '94' 7-max Seat #4 is the button
Seat 1: Hero (3,103,524 in chips)
Seat 3: e393edee (1,198,314 in chips)
Seat 4: b1f1b8dc (1,259,312 in chips)
Seat 6: 9feeaa16 (5,488,850 in chips)
Hero: posts the ante 20,000
e393edee: posts the ante 20,000
b1f1b8dc: posts the ante 20,000
9feeaa16: posts the ante 20,000
9feeaa16: posts small blind 70,000
Hero: posts big blind 140,000
*** HOLE CARDS ***
Dealt to Hero [Ts Tc]
Dealt to e393edee 
Dealt to b1f1b8dc 
Dealt to 9feeaa16 
e393edee: folds
b1f1b8dc: raises 1,099,312 to 1,239,312 and is all-in
9feeaa16: folds
Hero: calls 1,099,312
b1f1b8dc: shows [8h Ah]
Hero: shows [Ts Tc]
*** FLOP *** [Qs Qc 3d]
*** TURN *** [Qs Qc 3d] [Kd]
*** RIVER *** [Qs Qc 3d Kd] [Qd]
*** SHOWDOWN ***
Hero collected 2,628,624 from pot
*** SUMMARY ***
Total pot 2,628,624 | Rake 0 | Jackpot 0 | Bingo 0 | Fortune 0 | Tax 0
Board [Qs Qc 3d Kd Qd]
Seat 1: Hero (big blind) showed [Ts Tc] and won (2,628,624) with Queens Full over Tens
Seat 3: e393edee folded before Flop
Seat 4: b1f1b8dc (button) showed [8h Ah] and lost with Three Queens
Seat 6: 9feeaa16 (small blind) folded before Flop


Poker Hand #TM4181621293: Tournament #187165250, Mini Hypersonic $2.50 Hold'em No Limit - Level43(70,000/140,000) - 2025/02/03 18:50:58
Table '94' 7-max Seat #3 is the button
Seat 1: Hero (3,123,524 in chips)
Seat 3: e393edee (1,218,314 in chips)
Seat 4: b1f1b8dc (1,349,312 in chips)
Seat 6: 9feeaa16 (5,358,850 in chips)
Hero: posts the ante 20,000
e393edee: posts the ante 20,000
b1f1b8dc: posts the ante 20,000
9feeaa16: posts the ante 20,000
b1f1b8dc: posts small blind 70,000
9feeaa16: posts big blind 140,000
*** HOLE CARDS ***
Dealt to Hero [Jh 5c]
Dealt to e393edee 
Dealt to b1f1b8dc 
Dealt to 9feeaa16 
Hero: folds
e393edee: folds
b1f1b8dc: folds
Uncalled bet (70,000) returned to 9feeaa16
*** SHOWDOWN ***
9feeaa16 collected 220,000 from pot
*** SUMMARY ***
Total pot 220,000 | Rake 0 | Jackpot 0 | Bingo 0 | Fortune 0 | Tax 0
Seat 1: Hero folded before Flop
Seat 3: e393edee (button) folded before Flop
Seat 4: b1f1b8dc (small blind) folded before Flop
Seat 6: 9feeaa16 (big blind) collected (220,000)


Poker Hand #TM4181621282: Tournament #187165250, Mini Hypersonic $2.50 Hold'em No Limit - Level42(60,000/120,000) - 2025/02/03 18:50:46
Table '94' 7-max Seat #1 is the button
Seat 1: Hero (3,141,524 in chips)
Seat 3: e393edee (1,296,314 in chips)
Seat 4: b1f1b8dc (1,235,312 in chips)
Seat 6: 9feeaa16 (5,376,850 in chips)
Hero: posts the ante 18,000
e393edee: posts the ante 18,000
b1f1b8dc: posts the ante 18,000
9feeaa16: posts the ante 18,000
e393edee: posts small blind 60,000
b1f1b8dc: posts big blind 120,000
*** HOLE CARDS ***
Dealt to Hero [5s 3c]
Dealt to e393edee 
Dealt to b1f1b8dc 
Dealt to 9feeaa16 
9feeaa16: folds
Hero: folds
e393edee: folds
Uncalled bet (60,000) returned to b1f1b8dc
*** SHOWDOWN ***
b1f1b8dc collected 192,000 from pot
*** SUMMARY ***
Total pot 192,000 | Rake 0 | Jackpot 0 | Bingo 0 | Fortune 0 | Tax 0
Seat 1: Hero (button) folded before Flop
Seat 3: e393edee (small blind) folded before Flop
Seat 4: b1f1b8dc (big blind) collected (192,000)
Seat 6: 9feeaa16 folded before Flop


Poker Hand #TM4181621260: Tournament #187165250, Mini Hypersonic $2.50 Hold'em No Limit - Level42(60,000/120,000) - 2025/02/03 18:50:11
Table '94' 7-max Seat #6 is the button
Seat 1: Hero (3,219,524 in chips)
Seat 3: e393edee (1,865,970 in chips)
Seat 4: b1f1b8dc (569,656 in chips)
Seat 6: 9feeaa16 (5,394,850 in chips)
Hero: posts the ante 18,000
e393edee: posts the ante 18,000
b1f1b8dc: posts the ante 18,000
9feeaa16: posts the ante 18,000
Hero: posts small blind 60,000
e393edee: posts big blind 120,000
*** HOLE CARDS ***
Dealt to Hero [3h 4s]
Dealt to e393edee 
Dealt to b1f1b8dc 
Dealt to 9feeaa16 
b1f1b8dc: raises 431,656 to 551,656 and is all-in
9feeaa16: folds
Hero: folds
e393edee: calls 431,656
b1f1b8dc: shows [Qs Kd]
e393edee: shows [3d Ac]
*** FLOP *** [Qc 2s 8s]
*** TURN *** [Qc 2s 8s] [2d]
*** RIVER *** [Qc 2s 8s 2d] [8h]
*** SHOWDOWN ***
b1f1b8dc collected 1,235,312 from pot
*** SUMMARY ***
Total pot 1,235,312 | Rake 0 | Jackpot 0 | Bingo 0 | Fortune 0 | Tax 0
Board [Qc 2s 8s 2d 8h]
Seat 1: Hero (small blind) folded before Flop
Seat 3: e393edee (big blind) showed [3d Ac] and lost with Pair of Eights and Pair of Twos
Seat 4: b1f1b8dc showed [Qs Kd] and won (1,235,312) with Pair of Queens and Pair of Eights
Seat 6: 9feeaa16 (button) folded before Flop


Poker Hand #TM4181621252: Tournament #187165250, Mini Hypersonic $2.50 Hold'em No Limit - Level42(60,000/120,000) - 2025/02/03 18:50:01
Table '94' 7-max Seat #4 is the button
Seat 1: Hero (3,105,524 in chips)
Seat 3: e393edee (1,883,970 in chips)
Seat 4: b1f1b8dc (587,656 in chips)
Seat 6: 9feeaa16 (5,472,850 in chips)
Hero: posts the ante 18,000
e393edee: posts the ante 18,000
b1f1b8dc: posts the ante 18,000
9feeaa16: posts the ante 18,000
9feeaa16: posts small blind 60,000
Hero: posts big blind 120,000
*** HOLE CARDS ***
Dealt to Hero [Kc Jh]
Dealt to e393edee 
Dealt to b1f1b8dc 
Dealt to 9feeaa16 
e393edee: folds
b1f1b8dc: folds
9feeaa16: folds
Uncalled bet (60,000) returned to Hero
*** SHOWDOWN ***
Hero collected 192,000 from pot
*** SUMMARY ***
Total pot 192,000 | Rake 0 | Jackpot 0 | Bingo 0 | Fortune 0 | Tax 0
Seat 1: Hero (big blind) collected (192,000)
Seat 3: e393edee folded before Flop
Seat 4: b1f1b8dc (button) folded before Flop
Seat 6: 9feeaa16 (small blind) folded before Flop


Poker Hand #TM4181621224: Tournament #187165250, Mini Hypersonic $2.50 Hold'em No Limit - Level42(60,000/120,000) - 2025/02/03 18:49:19
Table '94' 7-max Seat #3 is the button
Seat 1: Hero (3,123,524 in chips)
Seat 3: e393edee (1,901,970 in chips)
Seat 4: b1f1b8dc (665,656 in chips)
Seat 5: 64249086 (69,262 in chips)
Seat 6: 9feeaa16 (5,289,588 in chips)
Hero: posts the ante 18,000
e393edee: posts the ante 18,000
b1f1b8dc: posts the ante 18,000
64249086: posts the ante 18,000
9feeaa16: posts the ante 18,000
b1f1b8dc: posts small blind 60,000
64249086: posts big blind 51,262
*** HOLE CARDS ***
Dealt to Hero [Ad 4h]
Dealt to e393edee 
Dealt to b1f1b8dc 
Dealt to 64249086 
Dealt to 9feeaa16 
9feeaa16: raises 5,151,588 to 5,271,588 and is all-in
Hero: folds
e393edee: folds
b1f1b8dc: folds
Uncalled bet (5,211,588) returned to 9feeaa16
9feeaa16: shows [9h Ah]
64249086: shows [5d 6h]
*** FLOP *** [9c Kh 9s]
*** TURN *** [9c Kh 9s] [2h]
*** RIVER *** [9c Kh 9s 2h] [6d]
e393edee: shows [Td As] (Pair of Nines)
*** SHOWDOWN ***
9feeaa16 collected 243,786 from pot
9feeaa16 collected 17,476 from pot
*** SUMMARY ***
Total pot 261,262 | Rake 0 | Jackpot 0 | Bingo 0 | Fortune 0 | Tax 0
Board [9c Kh 9s 2h 6d]
Seat 1: Hero folded before Flop
Seat 3: e393edee (button) folded before Flop
Seat 4: b1f1b8dc (small blind) folded before Flop
Seat 5: 64249086 (big blind) showed [5d 6h] and lost with Pair of Nines and Pair of Sixes
Seat 6: 9feeaa16 showed [9h Ah] and won (261,262) with Three Nines


Poker Hand #TM4181621206: Tournament #187165250, Mini Hypersonic $2.50 Hold'em No Limit - Level42(60,000/120,000) - 2025/02/03 18:48:58
Table '94' 7-max Seat #1 is the button
Seat 1: Hero (3,141,524 in chips)
Seat 3: e393edee (1,709,970 in chips)
Seat 4: b1f1b8dc (803,656 in chips)
Seat 5: 64249086 (87,262 in chips)
Seat 6: 9feeaa16 (5,307,588 in chips)
Hero: posts the ante 18,000
e393edee: posts the ante 18,000
b1f1b8dc: posts the ante 18,000
64249086: posts the ante 18,000
9feeaa16: posts the ante 18,000
e393edee: posts small blind 60,000
b1f1b8dc: posts big blind 120,000
*** HOLE CARDS ***
Dealt to Hero [Jc 5s]
Dealt to e393edee 
Dealt to b1f1b8dc 
Dealt to 64249086 
Dealt to 9feeaa16 
64249086: folds
9feeaa16: folds
Hero: folds
e393edee: raises 1,571,970 to 1,691,970 and is all-in
b1f1b8dc: folds
Uncalled bet (1,571,970) returned to e393edee
*** SHOWDOWN ***
e393edee collected 330,000 from pot
*** SUMMARY ***
Total pot 330,000 | Rake 0 | Jackpot 0 | Bingo 0 | Fortune 0 | Tax 0
Seat 1: Hero (button) folded before Flop
Seat 3: e393edee (small blind) collected (330,000)
Seat 4: b1f1b8dc (big blind) folded before Flop
Seat 5: 64249086 folded before Flop
Seat 6: 9feeaa16 folded before Flop


Poker Hand #TM4181621197: Tournament #187165250, Mini Hypersonic $2.50 Hold'em No Limit - Level42(60,000/120,000) - 2025/02/03 18:48:40
Table '94' 7-max Seat #6 is the button
Seat 1: Hero (2,949,524 in chips)
Seat 3: e393edee (1,847,970 in chips)
Seat 4: b1f1b8dc (821,656 in chips)
Seat 5: 64249086 (105,262 in chips)
Seat 6: 9feeaa16 (5,325,588 in chips)
Hero: posts the ante 18,000
e393edee: posts the ante 18,000
b1f1b8dc: posts the ante 18,000
64249086: posts the ante 18,000
9feeaa16: posts the ante 18,000
Hero: posts small blind 60,000
e393edee: posts big blind 120,000
*** HOLE CARDS ***
Dealt to Hero [4h 4d]
Dealt to e393edee 
Dealt to b1f1b8dc 
Dealt to 64249086 
Dealt to 9feeaa16 
b1f1b8dc: folds
64249086: folds
9feeaa16: folds
Hero: raises 1,920,000 to 2,040,000
e393edee: folds
Uncalled bet (1,920,000) returned to Hero
*** SHOWDOWN ***
Hero collected 330,000 from pot
*** SUMMARY ***
Total pot 330,000 | Rake 0 | Jackpot 0 | Bingo 0 | Fortune 0 | Tax 0
Seat 1: Hero (small blind) collected (330,000)
Seat 3: e393edee (big blind) folded before Flop
Seat 4: b1f1b8dc folded before Flop
Seat 5: 64249086 folded before Flop
Seat 6: 9feeaa16 (button) folded before Flop


Poker Hand #TM4181621190: Tournament #187165250, Mini Hypersonic $2.50 Hold'em No Limit - Level42(60,000/120,000) - 2025/02/03 18:48:28
Table '94' 7-max Seat #5 is the button
Seat 1: Hero (2,817,524 in chips)
Seat 3: e393edee (1,865,970 in chips)
Seat 4: b1f1b8dc (839,656 in chips)
Seat 5: 64249086 (123,262 in chips)
Seat 6: 9feeaa16 (5,403,588 in chips)
Hero: posts the ante 18,000
e393edee: posts the ante 18,000
b1f1b8dc: posts the ante 18,000
64249086: posts the ante 18,000
9feeaa16: posts the ante 18,000
9feeaa16: posts small blind 60,000
Hero: posts big blind 120,000
*** HOLE CARDS ***
Dealt to Hero [Ad 9s]
Dealt to e393edee 
Dealt to b1f1b8dc 
Dealt to 64249086 
Dealt to 9feeaa16 
e393edee: folds
b1f1b8dc: folds
64249086: folds
9feeaa16: folds
Uncalled bet (60,000) returned to Hero
*** SHOWDOWN ***
Hero collected 210,000 from pot
*** SUMMARY ***
Total pot 210,000 | Rake 0 | Jackpot 0 | Bingo 0 | Fortune 0 | Tax 0
Seat 1: Hero (big blind) collected (210,000)
Seat 3: e393edee folded before Flop
Seat 4: b1f1b8dc folded before Flop
Seat 5: 64249086 (button) folded before Flop
Seat 6: 9feeaa16 (small blind) folded before Flop


Poker Hand #TM4181621172: Tournament #187165250, Mini Hypersonic $2.50 Hold'em No Limit - Level42(60,000/120,000) - 2025/02/03 18:48:08
Table '94' 7-max Seat #4 is the button
Seat 1: Hero (2,835,524 in chips)
Seat 3: e393edee (1,883,970 in chips)
Seat 4: b1f1b8dc (857,656 in chips)
Seat 5: 64249086 (201,262 in chips)
Seat 6: 9feeaa16 (5,271,588 in chips)
Hero: posts the ante 18,000
e393edee: posts the ante 18,000
b1f1b8dc: posts the ante 18,000
64249086: posts the ante 18,000
9feeaa16: posts the ante 18,000
64249086: posts small blind 60,000
9feeaa16: posts big blind 120,000
*** HOLE CARDS ***
Dealt to Hero [Ts 7h]
Dealt to e393edee 
Dealt to b1f1b8dc 
Dealt to 64249086 
Dealt to 9feeaa16 
Hero: folds
e393edee: folds
b1f1b8dc: folds
64249086: folds
Uncalled bet (60,000) returned to 9feeaa16
*** SHOWDOWN ***
9feeaa16 collected 210,000 from pot
*** SUMMARY ***
Total pot 210,000 | Rake 0 | Jackpot 0 | Bingo 0 | Fortune 0 | Tax 0
Seat 1: Hero folded before Flop
Seat 3: e393edee folded before Flop
Seat 4: b1f1b8dc (button) folded before Flop
Seat 5: 64249086 (small blind) folded before Flop
Seat 6: 9feeaa16 (big blind) collected (210,000)


Poker Hand #TM4181621162: Tournament #187165250, Mini Hypersonic $2.50 Hold'em No Limit - Level42(60,000/120,000) - 2025/02/03 18:47:49
Table '94' 7-max Seat #3 is the button
Seat 1: Hero (3,093,524 in chips)
Seat 3: e393edee (1,391,970 in chips)
Seat 4: b1f1b8dc (935,656 in chips)
Seat 5: 64249086 (339,262 in chips)
Seat 6: 9feeaa16 (5,289,588 in chips)
Hero: posts the ante 18,000
e393edee: posts the ante 18,000
b1f1b8dc: posts the ante 18,000
64249086: posts the ante 18,000
9feeaa16: posts the ante 18,000
b1f1b8dc: posts small blind 60,000
64249086: posts big blind 120,000
*** HOLE CARDS ***
Dealt to Hero [Kh 9d]
Dealt to e393edee 
Dealt to b1f1b8dc 
Dealt to 64249086 
Dealt to 9feeaa16 
9feeaa16: folds
Hero: raises 120,000 to 240,000
e393edee: raises 1,133,970 to 1,373,970 and is all-in
b1f1b8dc: folds
64249086: folds
Hero: folds
Uncalled bet (1,133,970) returned to e393edee
*** SHOWDOWN ***
e393edee collected 750,000 from pot
*** SUMMARY ***
Total pot 750,000 | Rake 0 | Jackpot 0 | Bingo 0 | Fortune 0 | Tax 0
Seat 1: Hero folded before Flop
Seat 3: e393edee (button) collected (750,000)
Seat 4: b1f1b8dc (small blind) folded before Flop
Seat 5: 64249086 (big blind) folded before Flop
Seat 6: 9feeaa16 folded before Flop


Poker Hand #TM4181621152: Tournament #187165250, Mini Hypersonic $2.50 Hold'em No Limit - Level42(60,000/120,000) - 2025/02/03 18:47:31
Table '94' 7-max Seat #1 is the button
Seat 1: Hero (3,111,524 in chips)
Seat 3: e393edee (1,469,970 in chips)
Seat 4: b1f1b8dc (803,656 in chips)
Seat 5: 64249086 (357,262 in chips)
Seat 6: 9feeaa16 (5,307,588 in chips)
Hero: posts the ante 18,000
e393edee: posts the ante 18,000
b1f1b8dc: posts the ante 18,000
64249086: posts the ante 18,000
9feeaa16: posts the ante 18,000
e393edee: posts small blind 60,000
b1f1b8dc: posts big blind 120,000
*** HOLE CARDS ***
Dealt to Hero [4h 6s]
Dealt to e393edee 
Dealt to b1f1b8dc 
Dealt to 64249086 
Dealt to 9feeaa16 
64249086: folds
9feeaa16: folds
Hero: folds
e393edee: folds
Uncalled bet (60,000) returned to b1f1b8dc
*** SHOWDOWN ***
b1f1b8dc collected 210,000 from pot
*** SUMMARY ***
Total pot 210,000 | Rake 0 | Jackpot 0 | Bingo 0 | Fortune 0 | Tax 0
Seat 1: Hero (button) folded before Flop
Seat 3: e393edee (small blind) folded before Flop
Seat 4: b1f1b8dc (big blind) collected (210,000)
Seat 5: 64249086 folded before Flop
Seat 6: 9feeaa16 folded before Flop


Poker Hand #TM4181621126: Tournament #187165250, Mini Hypersonic $2.50 Hold'em No Limit - Level41(50,000/100,000) - 2025/02/03 18:46:47
Table '94' 7-max Seat #6 is the button
Seat 1: Hero (3,226,524 in chips)
Seat 3: e393edee (1,484,970 in chips)
Seat 4: b1f1b8dc (818,656 in chips)
Seat 5: 64249086 (372,262 in chips)
Seat 6: 9feeaa16 (2,696,077 in chips)
Seat 7: 71086af5 (2,451,511 in chips)
71086af5: posts the ante 15,000
Hero: posts the ante 15,000
e393edee: posts the ante 15,000
b1f1b8dc: posts the ante 15,000
64249086: posts the ante 15,000
9feeaa16: posts the ante 15,000
71086af5: posts small blind 50,000
Hero: posts big blind 100,000
*** HOLE CARDS ***
Dealt to Hero [2c 5h]
Dealt to e393edee 
Dealt to b1f1b8dc 
Dealt to 64249086 
Dealt to 9feeaa16 
Dealt to 71086af5 
e393edee: folds
b1f1b8dc: folds
64249086: folds
9feeaa16: raises 100,000 to 200,000
71086af5: raises 2,236,511 to 2,436,511 and is all-in
Hero: folds
9feeaa16: calls 2,236,511
71086af5: shows [Kh Ad]
9feeaa16: shows [Qs Qh]
*** FLOP *** [9s Js Ks]
*** TURN *** [9s Js Ks] [8c]
*** RIVER *** [9s Js Ks 8c] [As]
*** SHOWDOWN ***
9feeaa16 collected 5,063,022 from pot
*** SUMMARY ***
Total pot 5,063,022 | Rake 0 | Jackpot 0 | Bingo 0 | Fortune 0 | Tax 0
Board [9s Js Ks 8c As]
Seat 1: Hero (big blind) folded before Flop
Seat 3: e393edee folded before Flop
Seat 4: b1f1b8dc folded before Flop
Seat 5: 64249086 folded before Flop
Seat 6: 9feeaa16 (button) showed [Qs Qh] and won (5,063,022) with Ace High Flush
Seat 7: 71086af5 (small blind) showed [Kh Ad] and lost with Pair of Aces and Pair of Kings


Poker Hand #TM4181621114: Tournament #187165250, Mini Hypersonic $2.50 Hold'em No Limit - Level41(50,000/100,000) - 2025/02/03 18:46:33
Table '94' 7-max Seat #5 is the button
Seat 1: Hero (3,241,524 in chips)
Seat 3: e393edee (1,499,970 in chips)
Seat 4: b1f1b8dc (833,656 in chips)
Seat 5: 64249086 (387,262 in chips)
Seat 6: 9feeaa16 (2,761,077 in chips)
Seat 7: 71086af5 (2,326,511 in chips)
71086af5: posts the ante 15,000
Hero: posts the ante 15,000
e393edee: posts the ante 15,000
b1f1b8dc: posts the ante 15,000
64249086: posts the ante 15,000
9feeaa16: posts the ante 15,000
9feeaa16: posts small blind 50,000
71086af5: posts big blind 100,000
*** HOLE CARDS ***
Dealt to Hero [Jh 4h]
Dealt to e393edee 
Dealt to b1f1b8dc 
Dealt to 64249086 
Dealt to 9feeaa16 
Dealt to 71086af5 
Hero: folds
e393edee: folds
b1f1b8dc: folds
64249086: folds
9feeaa16: folds
Uncalled bet (50,000) returned to 71086af5
*** SHOWDOWN ***
71086af5 collected 190,000 from pot
*** SUMMARY ***
Total pot 190,000 | Rake 0 | Jackpot 0 | Bingo 0 | Fortune 0 | Tax 0
Seat 1: Hero folded before Flop
Seat 3: e393edee folded before Flop
Seat 4: b1f1b8dc folded before Flop
Seat 5: 64249086 (button) folded before Flop
Seat 6: 9feeaa16 (small blind) folded before Flop
Seat 7: 71086af5 (big blind) collected (190,000)


Poker Hand #TM4181621098: Tournament #187165250, Mini Hypersonic $2.50 Hold'em No Limit - Level41(50,000/100,000) - 2025/02/03 18:46:08
Table '94' 7-max Seat #4 is the button
Seat 1: Hero (3,256,524 in chips)
Seat 3: e393edee (1,514,970 in chips)
Seat 4: b1f1b8dc (848,656 in chips)
Seat 5: 64249086 (452,262 in chips)
Seat 6: 9feeaa16 (2,636,077 in chips)
Seat 7: 71086af5 (2,341,511 in chips)
71086af5: posts the ante 15,000
Hero: posts the ante 15,000
e393edee: posts the ante 15,000
b1f1b8dc: posts the ante 15,000
64249086: posts the ante 15,000
9feeaa16: posts the ante 15,000
64249086: posts small blind 50,000
9feeaa16: posts big blind 100,000
*** HOLE CARDS ***
Dealt to Hero [6d Kh]
Dealt to e393edee 
Dealt to b1f1b8dc 
Dealt to 64249086 
Dealt to 9feeaa16 
Dealt to 71086af5 
71086af5: folds
Hero: folds
e393edee: folds
b1f1b8dc: folds
64249086: folds
Uncalled bet (50,000) returned to 9feeaa16
*** SHOWDOWN ***
9feeaa16 collected 190,000 from pot
*** SUMMARY ***
Total pot 190,000 | Rake 0 | Jackpot 0 | Bingo 0 | Fortune 0 | Tax 0
Seat 1: Hero folded before Flop
Seat 3: e393edee folded before Flop
Seat 4: b1f1b8dc (button) folded before Flop
Seat 5: 64249086 (small blind) folded before Flop
Seat 6: 9feeaa16 (big blind) collected (190,000)
Seat 7: 71086af5 folded before Flop


Poker Hand #TM4181621090: Tournament #187165250, Mini Hypersonic $2.50 Hold'em No Limit - Level41(50,000/100,000) - 2025/02/03 18:45:51
Table '94' 7-max Seat #3 is the button
Seat 1: Hero (3,271,524 in chips)
Seat 3: e393edee (1,289,970 in chips)
Seat 4: b1f1b8dc (913,656 in chips)
Seat 5: 64249086 (567,262 in chips)
Seat 6: 9feeaa16 (2,651,077 in chips)
Seat 7: 71086af5 (2,356,511 in chips)
71086af5: posts the ante 15,000
Hero: posts the ante 15,000
e393edee: posts the ante 15,000
b1f1b8dc: posts the ante 15,000
64249086: posts the ante 15,000
9feeaa16: posts the ante 15,000
b1f1b8dc: posts small blind 50,000
64249086: posts big blind 100,000
*** HOLE CARDS ***
Dealt to Hero [2h 9c]
Dealt to e393edee 
Dealt to b1f1b8dc 
Dealt to 64249086 
Dealt to 9feeaa16 
Dealt to 71086af5 
9feeaa16: folds
71086af5: folds
Hero: folds
e393edee: raises 1,174,970 to 1,274,970 and is all-in
b1f1b8dc: folds
64249086: folds
Uncalled bet (1,174,970) returned to e393edee
*** SHOWDOWN ***
e393edee collected 340,000 from pot
*** SUMMARY ***
Total pot 340,000 | Rake 0 | Jackpot 0 | Bingo 0 | Fortune 0 | Tax 0
Seat 1: Hero folded before Flop
Seat 3: e393edee (button) collected (340,000)
Seat 4: b1f1b8dc (small blind) folded before Flop
Seat 5: 64249086 (big blind) folded before Flop
Seat 6: 9feeaa16 folded before Flop
Seat 7: 71086af5 folded before Flop


Poker Hand #TM4181621064: Tournament #187165250, Mini Hypersonic $2.50 Hold'em No Limit - Level41(50,000/100,000) - 2025/02/03 18:45:10
Table '94' 7-max Seat #1 is the button
Seat 1: Hero (3,286,524 in chips)
Seat 2: 1fdcb2a8 (78,544 in chips)
Seat 3: e393edee (1,404,970 in chips)
Seat 4: b1f1b8dc (928,656 in chips)
Seat 5: 64249086 (582,262 in chips)
Seat 6: 9feeaa16 (2,397,533 in chips)
Seat 7: 71086af5 (2,371,511 in chips)
71086af5: posts the ante 15,000
Hero: posts the ante 15,000
1fdcb2a8: posts the ante 15,000
e393edee: posts the ante 15,000
b1f1b8dc: posts the ante 15,000
64249086: posts the ante 15,000
9feeaa16: posts the ante 15,000
1fdcb2a8: posts small blind 50,000
e393edee: posts big blind 100,000
*** HOLE CARDS ***
Dealt to Hero [7h Th]
Dealt to 1fdcb2a8 
Dealt to e393edee 
Dealt to b1f1b8dc 
Dealt to 64249086 
Dealt to 9feeaa16 
Dealt to 71086af5 
b1f1b8dc: folds
64249086: folds
9feeaa16: raises 2,282,533 to 2,382,533 and is all-in
71086af5: folds
Hero: folds
1fdcb2a8: calls 13,544 and is all-in
e393edee: folds
Uncalled bet (2,282,533) returned to 9feeaa16
9feeaa16: shows [Kd Ac]
1fdcb2a8: shows [Kh Qc]
*** FLOP *** [6h 8d 2c]
*** TURN *** [6h 8d 2c] [4d]
*** RIVER *** [6h 8d 2c 4d] [3s]
71086af5: shows [Qh] (Queen-High)
e393edee: shows [5s] (Sixes-High Straight)
*** SHOWDOWN ***
9feeaa16 collected 295,632 from pot
9feeaa16 collected 72,912 from pot
*** SUMMARY ***
Total pot 368,544 | Rake 0 | Jackpot 0 | Bingo 0 | Fortune 0 | Tax 0
Board [6h 8d 2c 4d 3s]
Seat 1: Hero (button) folded before Flop
Seat 2: 1fdcb2a8 (small blind) showed [Kh Qc] and lost with King-High
Seat 3: e393edee (big blind) folded before Flop
Seat 4: b1f1b8dc folded before Flop
Seat 5: 64249086 folded before Flop
Seat 6: 9feeaa16 showed [Kd Ac] and won (368,544) with Ace-High
Seat 7: 71086af5 folded before Flop


Poker Hand #TM4181819203: Tournament #187165250, Mini Hypersonic $2.50 Hold'em No Limit - Level41(50,000/100,000) - 2025/02/03 18:43:47
Table '17' 6-max Seat #3 is the button
Seat 2: 64249086 (597,262 in chips)
Seat 3: Hero (2,549,370 in chips)
Seat 4: 1fdcb2a8 (143,544 in chips)
Seat 5: f7905baa (657,154 in chips)
f7905baa: posts the ante 15,000
Hero: posts the ante 15,000
1fdcb2a8: posts the ante 15,000
64249086: posts the ante 15,000
1fdcb2a8: posts small blind 50,000
f7905baa: posts big blind 100,000
*** HOLE CARDS ***
Dealt to 64249086 
Dealt to Hero [Qd 5s]
Dealt to 1fdcb2a8 
Dealt to f7905baa 
64249086: folds
Hero: raises 900,000 to 1,000,000
1fdcb2a8: folds
f7905baa: calls 542,154 and is all-in
Uncalled bet (357,846) returned to Hero
Hero: shows [Qd 5s]
f7905baa: shows [Kc 9c]
*** FLOP *** [3s 5d 3c]
*** TURN *** [3s 5d 3c] [8s]
*** RIVER *** [3s 5d 3c 8s] [Jh]
*** SHOWDOWN ***
Hero collected 1,394,308 from pot
*** SUMMARY ***
Total pot 1,394,308 | Rake 0 | Jackpot 0 | Bingo 0 | Fortune 0 | Tax 0
Board [3s 5d 3c 8s Jh]
Seat 2: 64249086 folded before Flop
Seat 3: Hero (button) showed [Qd 5s] and won (1,394,308) with Pair of Fives and Pair of Treys
Seat 4: 1fdcb2a8 (small blind) folded before Flop
Seat 5: f7905baa (big blind) showed [Kc 9c] and lost with Pair of Treys


Poker Hand #TM4181819182: Tournament #187165250, Mini Hypersonic $2.50 Hold'em No Limit - Level41(50,000/100,000) - 2025/02/03 18:43:19
Table '17' 6-max Seat #2 is the button
Seat 2: 64249086 (402,262 in chips)
Seat 3: Hero (2,614,370 in chips)
Seat 4: 1fdcb2a8 (258,544 in chips)
Seat 5: f7905baa (672,154 in chips)
f7905baa: posts the ante 15,000
Hero: posts the ante 15,000
1fdcb2a8: posts the ante 15,000
64249086: posts the ante 15,000
Hero: posts small blind 50,000
1fdcb2a8: posts big blind 100,000
*** HOLE CARDS ***
Dealt to 64249086 
Dealt to Hero [Jd 8s]
Dealt to 1fdcb2a8 
Dealt to f7905baa 
f7905baa: folds
64249086: raises 287,262 to 387,262 and is all-in
Hero: folds
1fdcb2a8: folds
Uncalled bet (287,262) returned to 64249086
*** SHOWDOWN ***
64249086 collected 310,000 from pot
*** SUMMARY ***
Total pot 310,000 | Rake 0 | Jackpot 0 | Bingo 0 | Fortune 0 | Tax 0
Seat 2: 64249086 (button) collected (310,000)
Seat 3: Hero (small blind) folded before Flop
Seat 4: 1fdcb2a8 (big blind) folded before Flop
Seat 5: f7905baa folded before Flop


Poker Hand #TM4181819155: Tournament #187165250, Mini Hypersonic $2.50 Hold'em No Limit - Level40(40,000/80,000) - 2025/02/03 18:42:34
Table '17' 6-max Seat #5 is the button
Seat 2: 64249086 (189,131 in chips)
Seat 3: Hero (2,803,501 in chips)
Seat 4: 1fdcb2a8 (270,544 in chips)
Seat 5: f7905baa (684,154 in chips)
f7905baa: posts the ante 12,000
Hero: posts the ante 12,000
1fdcb2a8: posts the ante 12,000
64249086: posts the ante 12,000
64249086: posts small blind 40,000
Hero: posts big blind 80,000
*** HOLE CARDS ***
Dealt to 64249086 
Dealt to Hero [7d 8d]
Dealt to 1fdcb2a8 
Dealt to f7905baa 
1fdcb2a8: folds
f7905baa: folds
64249086: raises 97,131 to 177,131 and is all-in
Hero: calls 97,131
64249086: shows [Jd Th]
Hero: shows [7d 8d]
*** FLOP *** [5d 4c 5c]
*** TURN *** [5d 4c 5c] [9c]
*** RIVER *** [5d 4c 5c 9c] [4d]
*** SHOWDOWN ***
64249086 collected 402,262 from pot
*** SUMMARY ***
Total pot 402,262 | Rake 0 | Jackpot 0 | Bingo 0 | Fortune 0 | Tax 0
Board [5d 4c 5c 9c 4d]
Seat 2: 64249086 (small blind) showed [Jd Th] and won (402,262) with Pair of Fives and Pair of Fours
Seat 3: Hero (big blind) showed [7d 8d] and lost with Pair of Fives and Pair of Fours
Seat 4: 1fdcb2a8 folded before Flop
Seat 5: f7905baa (button) folded before Flop


Poker Hand #TM4181819131: Tournament #187165250, Mini Hypersonic $2.50 Hold'em No Limit - Level40(40,000/80,000) - 2025/02/03 18:42:09
Table '17' 6-max Seat #4 is the button
Seat 2: 64249086 (281,131 in chips)
Seat 3: Hero (2,647,501 in chips)
Seat 4: 1fdcb2a8 (282,544 in chips)
Seat 5: f7905baa (736,154 in chips)
f7905baa: posts the ante 12,000
Hero: posts the ante 12,000
1fdcb2a8: posts the ante 12,000
64249086: posts the ante 12,000
f7905baa: posts small blind 40,000
64249086: posts big blind 80,000
*** HOLE CARDS ***
Dealt to 64249086 
Dealt to Hero [8c Ad]
Dealt to 1fdcb2a8 
Dealt to f7905baa 
Hero: raises 1,200,000 to 1,280,000
1fdcb2a8: folds
f7905baa: folds
64249086: folds
Uncalled bet (1,200,000) returned to Hero
*** SHOWDOWN ***
Hero collected 248,000 from pot
*** SUMMARY ***
Total pot 248,000 | Rake 0 | Jackpot 0 | Bingo 0 | Fortune 0 | Tax 0
Seat 2: 64249086 (big blind) folded before Flop
Seat 3: Hero collected (248,000)
Seat 4: 1fdcb2a8 (button) folded before Flop
Seat 5: f7905baa (small blind) folded before Flop


Poker Hand #TM4181819112: Tournament #187165250, Mini Hypersonic $2.50 Hold'em No Limit - Level40(40,000/80,000) - 2025/02/03 18:41:36
Table '17' 6-max Seat #3 is the button
Seat 2: 64249086 (293,131 in chips)
Seat 3: Hero (2,491,501 in chips)
Seat 4: 1fdcb2a8 (334,544 in chips)
Seat 5: f7905baa (828,154 in chips)
f7905baa: posts the ante 12,000
Hero: posts the ante 12,000
1fdcb2a8: posts the ante 12,000
64249086: posts the ante 12,000
1fdcb2a8: posts small blind 40,000
f7905baa: posts big blind 80,000
*** HOLE CARDS ***
Dealt to 64249086 
Dealt to Hero [Qd Kd]
Dealt to 1fdcb2a8 
Dealt to f7905baa 
64249086: folds
Hero: raises 960,000 to 1,040,000
1fdcb2a8: folds
f7905baa: folds
Uncalled bet (960,000) returned to Hero
*** SHOWDOWN ***
Hero collected 248,000 from pot
*** SUMMARY ***
Total pot 248,000 | Rake 0 | Jackpot 0 | Bingo 0 | Fortune 0 | Tax 0
Seat 2: 64249086 folded before Flop
Seat 3: Hero (button) collected (248,000)
Seat 4: 1fdcb2a8 (small blind) folded before Flop
Seat 5: f7905baa (big blind) folded before Flop


Poker Hand #TM4181819083: Tournament #187165250, Mini Hypersonic $2.50 Hold'em No Limit - Level40(40,000/80,000) - 2025/02/03 18:40:55
Table '17' 6-max Seat #2 is the button
Seat 2: 64249086 (305,131 in chips)
Seat 3: Hero (2,646,773 in chips)
Seat 4: 1fdcb2a8 (155,272 in chips)
Seat 5: f7905baa (840,154 in chips)
f7905baa: posts the ante 12,000
Hero: posts the ante 12,000
1fdcb2a8: posts the ante 12,000
64249086: posts the ante 12,000
Hero: posts small blind 40,000
1fdcb2a8: posts big blind 80,000
*** HOLE CARDS ***
Dealt to 64249086 
Dealt to Hero [Jd Jc]
Dealt to 1fdcb2a8 
Dealt to f7905baa 
f7905baa: folds
64249086: folds
Hero: raises 80,000 to 160,000
1fdcb2a8: calls 63,272 and is all-in
Uncalled bet (16,728) returned to Hero
Hero: shows [Jd Jc]
1fdcb2a8: shows [4s 8s]
*** FLOP *** [Kc 2h 5h]
*** TURN *** [Kc 2h 5h] [8c]
*** RIVER *** [Kc 2h 5h 8c] [4c]
*** SHOWDOWN ***
1fdcb2a8 collected 334,544 from pot
*** SUMMARY ***
Total pot 334,544 | Rake 0 | Jackpot 0 | Bingo 0 | Fortune 0 | Tax 0
Board [Kc 2h 5h 8c 4c]
Seat 2: 64249086 (button) folded before Flop
Seat 3: Hero (small blind) showed [Jd Jc] and lost with Pair of Jacks
Seat 4: 1fdcb2a8 (big blind) showed [4s 8s] and won (334,544) with Pair of Eights and Pair of Fours
Seat 5: f7905baa folded before Flop


Poker Hand #TM4180649064: Tournament #187165250, Mini Hypersonic $2.50 Hold'em No Limit - Level40(40,000/80,000) - 2025/02/03 18:40:27
Table '17' 6-max Seat #5 is the button
Seat 2: 64249086 (357,131 in chips)
Seat 3: Hero (2,570,773 in chips)
Seat 4: 1fdcb2a8 (167,272 in chips)
Seat 5: f7905baa (852,154 in chips)
f7905baa: posts the ante 12,000
Hero: posts the ante 12,000
1fdcb2a8: posts the ante 12,000
64249086: posts the ante 12,000
64249086: posts small blind 40,000
Hero: posts big blind 80,000
*** HOLE CARDS ***
Dealt to 64249086 
Dealt to Hero [Jc Kh]
Dealt to 1fdcb2a8 
Dealt to f7905baa 
1fdcb2a8: folds
f7905baa: folds
64249086: folds
Uncalled bet (40,000) returned to Hero
*** SHOWDOWN ***
Hero collected 128,000 from pot
*** SUMMARY ***
Total pot 128,000 | Rake 0 | Jackpot 0 | Bingo 0 | Fortune 0 | Tax 0
Seat 2: 64249086 (small blind) folded before Flop
Seat 3: Hero (big blind) collected (128,000)
Seat 4: 1fdcb2a8 folded before Flop
Seat 5: f7905baa (button) folded before Flop


Poker Hand #TM4180649042: Tournament #187165250, Mini Hypersonic $2.50 Hold'em No Limit - Level40(40,000/80,000) - 2025/02/03 18:39:56
Table '17' 6-max Seat #4 is the button
Seat 2: 64249086 (449,131 in chips)
Seat 3: Hero (2,582,773 in chips)
Seat 4: 1fdcb2a8 (179,272 in chips)
Seat 5: f7905baa (736,154 in chips)
f7905baa: posts the ante 12,000
Hero: posts the ante 12,000
1fdcb2a8: posts the ante 12,000
64249086: posts the ante 12,000
f7905baa: posts small blind 40,000
64249086: posts big blind 80,000
*** HOLE CARDS ***
Dealt to 64249086 
Dealt to Hero [Jh 3d]
Dealt to 1fdcb2a8 
Dealt to f7905baa 
Hero: folds
1fdcb2a8: folds
f7905baa: raises 644,154 to 724,154 and is all-in
64249086: folds
Uncalled bet (644,154) returned to f7905baa
*** SHOWDOWN ***
f7905baa collected 208,000 from pot
*** SUMMARY ***
Total pot 208,000 | Rake 0 | Jackpot 0 | Bingo 0 | Fortune 0 | Tax 0
Seat 2: 64249086 (big blind) folded before Flop
Seat 3: Hero folded before Flop
Seat 4: 1fdcb2a8 (button) folded before Flop
Seat 5: f7905baa (small blind) collected (208,000)


Poker Hand #TM4180649024: Tournament #187165250, Mini Hypersonic $2.50 Hold'em No Limit - Level40(40,000/80,000) - 2025/02/03 18:39:33
Table '17' 6-max Seat #3 is the button
Seat 2: 64249086 (461,131 in chips)
Seat 3: Hero (2,426,773 in chips)
Seat 4: 1fdcb2a8 (231,272 in chips)
Seat 5: f7905baa (828,154 in chips)
f7905baa: posts the ante 12,000
Hero: posts the ante 12,000
1fdcb2a8: posts the ante 12,000
64249086: posts the ante 12,000
1fdcb2a8: posts small blind 40,000
f7905baa: posts big blind 80,000
*** HOLE CARDS ***
Dealt to 64249086 
Dealt to Hero [Kd Js]
Dealt to 1fdcb2a8 
Dealt to f7905baa 
64249086: folds
Hero: raises 1,040,000 to 1,120,000
1fdcb2a8: folds
f7905baa: folds
Uncalled bet (1,040,000) returned to Hero
*** SHOWDOWN ***
Hero collected 248,000 from pot
*** SUMMARY ***
Total pot 248,000 | Rake 0 | Jackpot 0 | Bingo 0 | Fortune 0 | Tax 0
Seat 2: 64249086 folded before Flop
Seat 3: Hero (button) collected (248,000)
Seat 4: 1fdcb2a8 (small blind) folded before Flop
Seat 5: f7905baa (big blind) folded before Flop


Poker Hand #TM4180649011: Tournament #187165250, Mini Hypersonic $2.50 Hold'em No Limit - Level40(40,000/80,000) - 2025/02/03 18:39:07
Table '17' 6-max Seat #2 is the button
Seat 2: 64249086 (473,131 in chips)
Seat 3: Hero (2,310,773 in chips)
Seat 4: 1fdcb2a8 (323,272 in chips)
Seat 5: f7905baa (840,154 in chips)
f7905baa: posts the ante 12,000
Hero: posts the ante 12,000
1fdcb2a8: posts the ante 12,000
64249086: posts the ante 12,000
Hero: posts small blind 40,000
1fdcb2a8: posts big blind 80,000
*** HOLE CARDS ***
Dealt to 64249086 
Dealt to Hero [Kd 4h]
Dealt to 1fdcb2a8 
Dealt to f7905baa 
f7905baa: folds
64249086: folds
Hero: raises 800,000 to 880,000
1fdcb2a8: folds
Uncalled bet (800,000) returned to Hero
*** SHOWDOWN ***
Hero collected 208,000 from pot
*** SUMMARY ***
Total pot 208,000 | Rake 0 | Jackpot 0 | Bingo 0 | Fortune 0 | Tax 0
Seat 2: 64249086 (button) folded before Flop
Seat 3: Hero (small blind) collected (208,000)
Seat 4: 1fdcb2a8 (big blind) folded before Flop
Seat 5: f7905baa folded before Flop


Poker Hand #TM4180648984: Tournament #187165250, Mini Hypersonic $2.50 Hold'em No Limit - Level39(35,000/70,000) - 2025/02/03 18:38:37
Table '17' 6-max Seat #5 is the button
Seat 2: 64249086 (518,131 in chips)
Seat 3: Hero (2,105,773 in chips)
Seat 4: 1fdcb2a8 (333,272 in chips)
Seat 5: f7905baa (990,154 in chips)
f7905baa: posts the ante 10,000
Hero: posts the ante 10,000
1fdcb2a8: posts the ante 10,000
64249086: posts the ante 10,000
64249086: posts small blind 35,000
Hero: posts big blind 70,000
*** HOLE CARDS ***
Dealt to 64249086 
Dealt to Hero [Ac Js]
Dealt to 1fdcb2a8 
Dealt to f7905baa 
1fdcb2a8: folds
f7905baa: raises 70,000 to 140,000
64249086: folds
Hero: raises 1,400,000 to 1,540,000
f7905baa: folds
Uncalled bet (1,400,000) returned to Hero
*** SHOWDOWN ***
Hero collected 355,000 from pot
*** SUMMARY ***
Total pot 355,000 | Rake 0 | Jackpot 0 | Bingo 0 | Fortune 0 | Tax 0
Seat 2: 64249086 (small blind) folded before Flop
Seat 3: Hero (big blind) collected (355,000)
Seat 4: 1fdcb2a8 folded before Flop
Seat 5: f7905baa (button) folded before Flop


Poker Hand #TM4180648955: Tournament #187165250, Mini Hypersonic $2.50 Hold'em No Limit - Level39(35,000/70,000) - 2025/02/03 18:37:54
Table '17' 6-max Seat #4 is the button
Seat 2: 64249086 (657,267 in chips)
Seat 3: Hero (2,115,773 in chips)
Seat 4: 1fdcb2a8 (139,136 in chips)
Seat 5: f7905baa (1,035,154 in chips)
f7905baa: posts the ante 10,000
Hero: posts the ante 10,000
1fdcb2a8: posts the ante 10,000
64249086: posts the ante 10,000
f7905baa: posts small blind 35,000
64249086: posts big blind 70,000
*** HOLE CARDS ***
Dealt to 64249086 
Dealt to Hero [Qd 5s]
Dealt to 1fdcb2a8 
Dealt to f7905baa 
Hero: folds
1fdcb2a8: raises 59,136 to 129,136 and is all-in
f7905baa: folds
64249086: calls 59,136
1fdcb2a8: shows [7s 7c]
64249086: shows [Kc 2h]
*** FLOP *** [8h Qc 2s]
*** TURN *** [8h Qc 2s] [6h]
*** RIVER *** [8h Qc 2s 6h] [4h]
*** SHOWDOWN ***
1fdcb2a8 collected 333,272 from pot
*** SUMMARY ***
Total pot 333,272 | Rake 0 | Jackpot 0 | Bingo 0 | Fortune 0 | Tax 0
Board [8h Qc 2s 6h 4h]
Seat 2: 64249086 (big blind) showed [Kc 2h] and lost with Pair of Twos
Seat 3: Hero folded before Flop
Seat 4: 1fdcb2a8 (button) showed [7s 7c] and won (333,272) with Pair of Sevens
Seat 5: f7905baa (small blind) folded before Flop


Poker Hand #TM4180648919: Tournament #187165250, Mini Hypersonic $2.50 Hold'em No Limit - Level39(35,000/70,000) - 2025/02/03 18:37:06
Table '17' 6-max Seat #3 is the button
Seat 1: d63f99e5 (448,373 in chips)
Seat 2: 64249086 (667,267 in chips)
Seat 3: Hero (1,532,400 in chips)
Seat 4: 1fdcb2a8 (184,136 in chips)
Seat 5: f7905baa (1,115,154 in chips)
f7905baa: posts the ante 10,000
Hero: posts the ante 10,000
1fdcb2a8: posts the ante 10,000
d63f99e5: posts the ante 10,000
64249086: posts the ante 10,000
1fdcb2a8: posts small blind 35,000
f7905baa: posts big blind 70,000
*** HOLE CARDS ***
Dealt to d63f99e5 
Dealt to 64249086 
Dealt to Hero [Jd Js]
Dealt to 1fdcb2a8 
Dealt to f7905baa 
d63f99e5: raises 368,373 to 438,373 and is all-in
64249086: folds
Hero: raises 1,084,027 to 1,522,400 and is all-in
1fdcb2a8: folds
f7905baa: folds
Uncalled bet (1,084,027) returned to Hero
Hero: shows [Jd Js]
d63f99e5: shows [Kd As]
*** FLOP *** [Ts Th 2s]
*** TURN *** [Ts Th 2s] [4h]
*** RIVER *** [Ts Th 2s 4h] [5d]
*** SHOWDOWN ***
Hero collected 1,031,746 from pot
*** SUMMARY ***
Total pot 1,031,746 | Rake 0 | Jackpot 0 | Bingo 0 | Fortune 0 | Tax 0
Board [Ts Th 2s 4h 5d]
Seat 1: d63f99e5 showed [Kd As] and lost with Pair of Tens
Seat 2: 64249086 folded before Flop
Seat 3: Hero (button) showed [Jd Js] and won (1,031,746) with Pair of Jacks and Pair of Tens
Seat 4: 1fdcb2a8 (small blind) folded before Flop
Seat 5: f7905baa (big blind) folded before Flop


Poker Hand #TM4180648903: Tournament #187165250, Mini Hypersonic $2.50 Hold'em No Limit - Level39(35,000/70,000) - 2025/02/03 18:36:41
Table '17' 6-max Seat #2 is the button
Seat 1: d63f99e5 (303,373 in chips)
Seat 2: 64249086 (677,267 in chips)
Seat 3: Hero (1,577,400 in chips)
Seat 4: 1fdcb2a8 (264,136 in chips)
Seat 5: f7905baa (1,125,154 in chips)
f7905baa: posts the ante 10,000
Hero: posts the ante 10,000
1fdcb2a8: posts the ante 10,000
d63f99e5: posts the ante 10,000
64249086: posts the ante 10,000
Hero: posts small blind 35,000
1fdcb2a8: posts big blind 70,000
*** HOLE CARDS ***
Dealt to d63f99e5 
Dealt to 64249086 
Dealt to Hero [5d Tc]
Dealt to 1fdcb2a8 
Dealt to f7905baa 
f7905baa: folds
d63f99e5: raises 223,373 to 293,373 and is all-in
64249086: folds
Hero: folds
1fdcb2a8: folds
Uncalled bet (223,373) returned to d63f99e5
*** SHOWDOWN ***
d63f99e5 collected 225,000 from pot
*** SUMMARY ***
Total pot 225,000 | Rake 0 | Jackpot 0 | Bingo 0 | Fortune 0 | Tax 0
Seat 1: d63f99e5 collected (225,000)
Seat 2: 64249086 (button) folded before Flop
Seat 3: Hero (small blind) folded before Flop
Seat 4: 1fdcb2a8 (big blind) folded before Flop
Seat 5: f7905baa folded before Flop


Poker Hand #TM4180648885: Tournament #187165250, Mini Hypersonic $2.50 Hold'em No Limit - Level39(35,000/70,000) - 2025/02/03 18:36:15
Table '17' 6-max Seat #1 is the button
Seat 1: d63f99e5 (313,373 in chips)
Seat 2: 64249086 (722,267 in chips)
Seat 3: Hero (1,502,400 in chips)
Seat 4: 1fdcb2a8 (274,136 in chips)
Seat 5: f7905baa (1,135,154 in chips)
f7905baa: posts the ante 10,000
Hero: posts the ante 10,000
1fdcb2a8: posts the ante 10,000
d63f99e5: posts the ante 10,000
64249086: posts the ante 10,000
64249086: posts small blind 35,000
Hero: posts big blind 70,000
*** HOLE CARDS ***
Dealt to d63f99e5 
Dealt to 64249086 
Dealt to Hero [5c Js]
Dealt to 1fdcb2a8 
Dealt to f7905baa 
1fdcb2a8: folds
f7905baa: folds
d63f99e5: folds
64249086: folds
Uncalled bet (35,000) returned to Hero
*** SHOWDOWN ***
Hero collected 120,000 from pot
*** SUMMARY ***
Total pot 120,000 | Rake 0 | Jackpot 0 | Bingo 0 | Fortune 0 | Tax 0
Seat 1: d63f99e5 (button) folded before Flop
Seat 2: 64249086 (small blind) folded before Flop
Seat 3: Hero (big blind) collected (120,000)
Seat 4: 1fdcb2a8 folded before Flop
Seat 5: f7905baa folded before Flop


Poker Hand #TM4180648836: Tournament #187165250, Mini Hypersonic $2.50 Hold'em No Limit - Level39(35,000/70,000) - 2025/02/03 18:35:12
Table '17' 6-max Seat #5 is the button
Seat 1: d63f99e5 (358,373 in chips)
Seat 2: 64249086 (826,835 in chips)
Seat 3: Hero (1,512,400 in chips)
Seat 4: 1fdcb2a8 (104,568 in chips)
Seat 5: f7905baa (1,145,154 in chips)
f7905baa: posts the ante 10,000
Hero: posts the ante 10,000
1fdcb2a8: posts the ante 10,000
d63f99e5: posts the ante 10,000
64249086: posts the ante 10,000
d63f99e5: posts small blind 35,000
64249086: posts big blind 70,000
*** HOLE CARDS ***
Dealt to d63f99e5 
Dealt to 64249086 
Dealt to Hero [2h Jd]
Dealt to 1fdcb2a8 
Dealt to f7905baa 
Hero: folds
1fdcb2a8: raises 24,568 to 94,568 and is all-in
f7905baa: folds
d63f99e5: folds
64249086: calls 24,568
1fdcb2a8: shows [4h 4d]
64249086: shows [7c 2d]
*** FLOP *** [As 3c Jc]
*** TURN *** [As 3c Jc] [6s]
*** RIVER *** [As 3c Jc 6s] [5d]
*** SHOWDOWN ***
1fdcb2a8 collected 274,136 from pot
*** SUMMARY ***
Total pot 274,136 | Rake 0 | Jackpot 0 | Bingo 0 | Fortune 0 | Tax 0
Board [As 3c Jc 6s 5d]
Seat 1: d63f99e5 (small blind) folded before Flop
Seat 2: 64249086 (big blind) showed [7c 2d] and lost with Ace-High
Seat 3: Hero folded before Flop
Seat 4: 1fdcb2a8 showed [4h 4d] and won (274,136) with Pair of Fours
Seat 5: f7905baa (button) folded before Flop


Poker Hand #TM4180648793: Tournament #187165250, Mini Hypersonic $2.50 Hold'em No Limit - Level38(30,000/60,000) - 2025/02/03 18:34:17
Table '17' 6-max Seat #4 is the button
Seat 1: d63f99e5 (329,873 in chips)
Seat 2: 64249086 (835,835 in chips)
Seat 3: Hero (1,521,400 in chips)
Seat 4: 1fdcb2a8 (76,068 in chips)
Seat 5: f7905baa (1,184,154 in chips)
f7905baa: posts the ante 9,000
Hero: posts the ante 9,000
1fdcb2a8: posts the ante 9,000
d63f99e5: posts the ante 9,000
64249086: posts the ante 9,000
f7905baa: posts small blind 30,000
d63f99e5: posts big blind 60,000
*** HOLE CARDS ***
Dealt to d63f99e5 
Dealt to 64249086 
Dealt to Hero [8d 9s]
Dealt to 1fdcb2a8 
Dealt to f7905baa 
64249086: folds
Hero: folds
1fdcb2a8: raises 7,068 to 67,068 and is all-in
f7905baa: folds
d63f99e5: calls 7,068
1fdcb2a8: shows [2c Ad]
d63f99e5: shows [6h As]
*** FLOP *** [3h Ah 3c]
*** TURN *** [3h Ah 3c] [7h]
*** RIVER *** [3h Ah 3c 7h] [Js]
*** SHOWDOWN ***
d63f99e5 collected 104,568 from pot
1fdcb2a8 collected 104,568 from pot
*** SUMMARY ***
Total pot 209,136 | Rake 0 | Jackpot 0 | Bingo 0 | Fortune 0 | Tax 0
Board [3h Ah 3c 7h Js]
Seat 1: d63f99e5 (big blind) showed [6h As] and won (104,568) with Pair of Aces and Pair of Treys
Seat 2: 64249086 folded before Flop
Seat 3: Hero folded before Flop
Seat 4: 1fdcb2a8 (button) showed [2c Ad] and won (104,568) with Pair of Aces and Pair of Treys
Seat 5: f7905baa (small blind) folded before Flop


Poker Hand #TM4180648733: Tournament #187165250, Mini Hypersonic $2.50 Hold'em No Limit - Level38(30,000/60,000) - 2025/02/03 18:32:54
Table '17' 6-max Seat #3 is the button
Seat 1: d63f99e5 (338,873 in chips)
Seat 2: 64249086 (844,835 in chips)
Seat 3: Hero (1,002,400 in chips)
Seat 4: 1fdcb2a8 (115,068 in chips)
Seat 5: f7905baa (1,637,154 in chips)
Seat 6: 9feeaa16 (1,124,057 in chips)
f7905baa: posts the ante 9,000
Hero: posts the ante 9,000
1fdcb2a8: posts the ante 9,000
d63f99e5: posts the ante 9,000
64249086: posts the ante 9,000
9feeaa16: posts the ante 9,000
1fdcb2a8: posts small blind 30,000
f7905baa: posts big blind 60,000
*** HOLE CARDS ***
Dealt to d63f99e5 
Dealt to 64249086 
Dealt to Hero [Js 8s]
Dealt to 1fdcb2a8 
Dealt to f7905baa 
Dealt to 9feeaa16 
9feeaa16: folds
d63f99e5: folds
64249086: folds
Hero: raises 60,000 to 120,000
1fdcb2a8: folds
f7905baa: calls 60,000
*** FLOP *** [Td Jc 4s]
f7905baa: checks
Hero: bets 81,000
f7905baa: calls 81,000
*** TURN *** [Td Jc 4s] [3s]
f7905baa: checks
Hero: checks
*** RIVER *** [Td Jc 4s 3s] [Qs]
f7905baa: bets 243,000
Hero: raises 549,400 to 792,400 and is all-in
f7905baa: folds
Uncalled bet (549,400) returned to Hero
*** SHOWDOWN ***
Hero collected 972,000 from pot
*** SUMMARY ***
Total pot 972,000 | Rake 0 | Jackpot 0 | Bingo 0 | Fortune 0 | Tax 0
Board [Td Jc 4s 3s Qs]
Seat 1: d63f99e5 folded before Flop
Seat 2: 64249086 folded before Flop
Seat 3: Hero (button) won (972,000)
Seat 4: 1fdcb2a8 (small blind) folded before Flop
Seat 5: f7905baa (big blind) folded on the River
Seat 6: 9feeaa16 folded before Flop


Poker Hand #TM4180648704: Tournament #187165250, Mini Hypersonic $2.50 Hold'em No Limit - Level38(30,000/60,000) - 2025/02/03 18:32:17
Table '17' 6-max Seat #2 is the button
Seat 1: d63f99e5 (358,585 in chips)
Seat 2: 64249086 (853,835 in chips)
Seat 3: Hero (1,041,400 in chips)
Seat 4: 1fdcb2a8 (29,356 in chips)
Seat 5: f7905baa (1,646,154 in chips)
Seat 6: 9feeaa16 (1,133,057 in chips)
f7905baa: posts the ante 9,000
Hero: posts the ante 9,000
1fdcb2a8: posts the ante 9,000
d63f99e5: posts the ante 9,000
64249086: posts the ante 9,000
9feeaa16: posts the ante 9,000
Hero: posts small blind 30,000
1fdcb2a8: posts big blind 20,356
*** HOLE CARDS ***
Dealt to d63f99e5 
Dealt to 64249086 
Dealt to Hero [9d Kd]
Dealt to 1fdcb2a8 
Dealt to f7905baa 
Dealt to 9feeaa16 
f7905baa: folds
9feeaa16: folds
d63f99e5: raises 289,585 to 349,585 and is all-in
64249086: folds
Hero: folds
Uncalled bet (319,585) returned to d63f99e5
d63f99e5: shows [3h Ad]
1fdcb2a8: shows [Qc Qs]
*** FLOP *** [6h 4d 5d]
*** TURN *** [6h 4d 5d] [3s]
*** RIVER *** [6h 4d 5d 3s] [Qd]
*** SHOWDOWN ***
1fdcb2a8 collected 115,068 from pot
d63f99e5 collected 19,288 from pot
*** SUMMARY ***
Total pot 134,356 | Rake 0 | Jackpot 0 | Bingo 0 | Fortune 0 | Tax 0
Board [6h 4d 5d 3s Qd]
Seat 1: d63f99e5 showed [3h Ad] and won (19,288) with Pair of Treys
Seat 2: 64249086 (button) folded before Flop
Seat 3: Hero (small blind) folded before Flop
Seat 4: 1fdcb2a8 (big blind) showed [Qc Qs] and won (115,068) with Three Queens
Seat 5: f7905baa folded before Flop
Seat 6: 9feeaa16 folded before Flop


Poker Hand #TM4180648648: Tournament #187165250, Mini Hypersonic $2.50 Hold'em No Limit - Level38(30,000/60,000) - 2025/02/03 18:31:02
Table '17' 6-max Seat #1 is the button
Seat 1: d63f99e5 (367,585 in chips)
Seat 2: 64249086 (892,835 in chips)
Seat 3: Hero (487,700 in chips)
Seat 4: 1fdcb2a8 (38,356 in chips)
Seat 5: f7905baa (2,133,854 in chips)
Seat 6: 9feeaa16 (1,142,057 in chips)
f7905baa: posts the ante 9,000
Hero: posts the ante 9,000
1fdcb2a8: posts the ante 9,000
d63f99e5: posts the ante 9,000
64249086: posts the ante 9,000
9feeaa16: posts the ante 9,000
64249086: posts small blind 30,000
Hero: posts big blind 60,000
*** HOLE CARDS ***
Dealt to d63f99e5 
Dealt to 64249086 
Dealt to Hero [Ah Jd]
Dealt to 1fdcb2a8 
Dealt to f7905baa 
Dealt to 9feeaa16 
1fdcb2a8: folds
f7905baa: raises 60,000 to 120,000
9feeaa16: folds
d63f99e5: folds
64249086: folds
Hero: raises 358,700 to 478,700 and is all-in
f7905baa: calls 358,700
Hero: shows [Ah Jd]
f7905baa: shows [8c Qs]
*** FLOP *** [6s 9c 4s]
*** TURN *** [6s 9c 4s] [Ks]
*** RIVER *** [6s 9c 4s Ks] [4d]
d63f99e5: shows [Kc 9h] (Pair of Kings and Pair of Nines)
*** SHOWDOWN ***
Hero collected 1,041,400 from pot
*** SUMMARY ***
Total pot 1,041,400 | Rake 0 | Jackpot 0 | Bingo 0 | Fortune 0 | Tax 0
Board [6s 9c 4s Ks 4d]
Seat 1: d63f99e5 (button) folded before Flop
Seat 2: 64249086 (small blind) folded before Flop
Seat 3: Hero (big blind) showed [Ah Jd] and won (1,041,400) with Pair of Fours
Seat 4: 1fdcb2a8 folded before Flop
Seat 5: f7905baa showed [8c Qs] and lost with Pair of Fours
Seat 6: 9feeaa16 folded before Flop


Poker Hand #TM4180648594: Tournament #187165250, Mini Hypersonic $2.50 Hold'em No Limit - Level37(25,000/50,000) - 2025/02/03 18:29:53
Table '40' 6-max Seat #2 is the button
Seat 1: b81c9328 (443,944 in chips)
Seat 2: 9feeaa16 (1,149,557 in chips)
Seat 3: dd346f3c (163,596 in chips)
Seat 4: b1f1b8dc (1,020,712 in chips)
Seat 6: Hero (495,200 in chips)
Hero: posts the ante 7,500
b81c9328: posts the ante 7,500
b1f1b8dc: posts the ante 7,500
9feeaa16: posts the ante 7,500
dd346f3c: posts the ante 7,500
dd346f3c: posts small blind 25,000
b1f1b8dc: posts big blind 50,000
*** HOLE CARDS ***
Dealt to b81c9328 
Dealt to 9feeaa16 
Dealt to dd346f3c 
Dealt to b1f1b8dc 
Dealt to Hero [6h 2s]
Hero: folds
b81c9328: raises 375,000 to 425,000
9feeaa16: folds
dd346f3c: folds
b1f1b8dc: raises 375,000 to 800,000
b81c9328: calls 11,444 and is all-in
Uncalled bet (363,556) returned to b1f1b8dc
b1f1b8dc: shows [5d 5h]
b81c9328: shows [Ts Td]
*** FLOP *** [Qs 3d Qd]
*** TURN *** [Qs 3d Qd] [7d]
*** RIVER *** [Qs 3d Qd 7d] [5s]
*** SHOWDOWN ***
b1f1b8dc collected 935,388 from pot
*** SUMMARY ***
Total pot 935,388 | Rake 0 | Jackpot 0 | Bingo 0 | Fortune 0 | Tax 0
Board [Qs 3d Qd 7d 5s]
Seat 1: b81c9328 showed [Ts Td] and lost with Pair of Queens and Pair of Tens
Seat 2: 9feeaa16 (button) folded before Flop
Seat 3: dd346f3c (small blind) folded before Flop
Seat 4: b1f1b8dc (big blind) showed [5d 5h] and won (935,388) with Fives Full over Queens
Seat 6: Hero folded before Flop


Poker Hand #TM4180648587: Tournament #187165250, Mini Hypersonic $2.50 Hold'em No Limit - Level37(25,000/50,000) - 2025/02/03 18:29:38
Table '40' 6-max Seat #1 is the button
Seat 1: b81c9328 (451,444 in chips)
Seat 2: 9feeaa16 (1,069,557 in chips)
Seat 3: dd346f3c (221,096 in chips)
Seat 4: b1f1b8dc (1,028,212 in chips)
Seat 6: Hero (502,700 in chips)
Hero: posts the ante 7,500
b81c9328: posts the ante 7,500
b1f1b8dc: posts the ante 7,500
9feeaa16: posts the ante 7,500
dd346f3c: posts the ante 7,500
9feeaa16: posts small blind 25,000
dd346f3c: posts big blind 50,000
*** HOLE CARDS ***
Dealt to b81c9328 
Dealt to 9feeaa16 
Dealt to dd346f3c 
Dealt to b1f1b8dc 
Dealt to Hero [6s 5s]
b1f1b8dc: folds
Hero: folds
b81c9328: folds
9feeaa16: raises 1,012,057 to 1,062,057 and is all-in
dd346f3c: folds
Uncalled bet (1,012,057) returned to 9feeaa16
*** SHOWDOWN ***
9feeaa16 collected 137,500 from pot
*** SUMMARY ***
Total pot 137,500 | Rake 0 | Jackpot 0 | Bingo 0 | Fortune 0 | Tax 0
Seat 1: b81c9328 (button) folded before Flop
Seat 2: 9feeaa16 (small blind) collected (137,500)
Seat 3: dd346f3c (big blind) folded before Flop
Seat 4: b1f1b8dc folded before Flop
Seat 6: Hero folded before Flop


Poker Hand #TM4180648573: Tournament #187165250, Mini Hypersonic $2.50 Hold'em No Limit - Level37(25,000/50,000) - 2025/02/03 18:29:20
Table '40' 6-max Seat #6 is the button
Seat 1: b81c9328 (371,444 in chips)
Seat 2: 9feeaa16 (1,127,057 in chips)
Seat 3: dd346f3c (228,596 in chips)
Seat 4: b1f1b8dc (1,035,712 in chips)
Seat 6: Hero (510,200 in chips)
Hero: posts the ante 7,500
b81c9328: posts the ante 7,500
b1f1b8dc: posts the ante 7,500
9feeaa16: posts the ante 7,500
dd346f3c: posts the ante 7,500
b81c9328: posts small blind 25,000
9feeaa16: posts big blind 50,000
*** HOLE CARDS ***
Dealt to b81c9328 
Dealt to 9feeaa16 
Dealt to dd346f3c 
Dealt to b1f1b8dc 
Dealt to Hero [Kd 7s]
dd346f3c: folds
b1f1b8dc: folds
Hero: folds
b81c9328: raises 100,000 to 150,000
9feeaa16: folds
Uncalled bet (100,000) returned to b81c9328
*** SHOWDOWN ***
b81c9328 collected 137,500 from pot
*** SUMMARY ***
Total pot 137,500 | Rake 0 | Jackpot 0 | Bingo 0 | Fortune 0 | Tax 0
Seat 1: b81c9328 (small blind) collected (137,500)
Seat 2: 9feeaa16 (big blind) folded before Flop
Seat 3: dd346f3c folded before Flop
Seat 4: b1f1b8dc folded before Flop
Seat 6: Hero (button) folded before Flop


Poker Hand #TM4180648550: Tournament #187165250, Mini Hypersonic $2.50 Hold'em No Limit - Level37(25,000/50,000) - 2025/02/03 18:28:59
Table '40' 6-max Seat #4 is the button
Seat 1: b81c9328 (428,944 in chips)
Seat 2: 9feeaa16 (1,134,557 in chips)
Seat 3: dd346f3c (236,096 in chips)
Seat 4: b1f1b8dc (1,043,212 in chips)
Seat 6: Hero (430,200 in chips)
Hero: posts the ante 7,500
b81c9328: posts the ante 7,500
b1f1b8dc: posts the ante 7,500
9feeaa16: posts the ante 7,500
dd346f3c: posts the ante 7,500
Hero: posts small blind 25,000
b81c9328: posts big blind 50,000
*** HOLE CARDS ***
Dealt to b81c9328 
Dealt to 9feeaa16 
Dealt to dd346f3c 
Dealt to b1f1b8dc 
Dealt to Hero [Jh Kh]
9feeaa16: folds
dd346f3c: folds
b1f1b8dc: folds
Hero: raises 372,700 to 422,700 and is all-in
b81c9328: folds
Uncalled bet (372,700) returned to Hero
*** SHOWDOWN ***
Hero collected 137,500 from pot
*** SUMMARY ***
Total pot 137,500 | Rake 0 | Jackpot 0 | Bingo 0 | Fortune 0 | Tax 0
Seat 1: b81c9328 (big blind) folded before Flop
Seat 2: 9feeaa16 folded before Flop
Seat 3: dd346f3c folded before Flop
Seat 4: b1f1b8dc (button) folded before Flop
Seat 6: Hero (small blind) collected (137,500)


Poker Hand #TM4180648522: Tournament #187165250, Mini Hypersonic $2.50 Hold'em No Limit - Level37(25,000/50,000) - 2025/02/03 18:28:17
Table '40' 6-max Seat #3 is the button
Seat 1: b81c9328 (436,444 in chips)
Seat 2: 9feeaa16 (624,050 in chips)
Seat 3: dd346f3c (243,596 in chips)
Seat 4: b1f1b8dc (1,075,712 in chips)
Seat 5: b11600f1 (455,507 in chips)
Seat 6: Hero (437,700 in chips)
Hero: posts the ante 7,500
b81c9328: posts the ante 7,500
b1f1b8dc: posts the ante 7,500
9feeaa16: posts the ante 7,500
dd346f3c: posts the ante 7,500
b11600f1: posts the ante 7,500
b1f1b8dc: posts small blind 25,000
b11600f1: posts big blind 50,000
*** HOLE CARDS ***
Dealt to b81c9328 
Dealt to 9feeaa16 
Dealt to dd346f3c 
Dealt to b1f1b8dc 
Dealt to b11600f1 
Dealt to Hero [Tc Jd]
Hero: folds
b81c9328: folds
9feeaa16: raises 566,550 to 616,550 and is all-in
dd346f3c: folds
b1f1b8dc: folds
b11600f1: calls 398,007 and is all-in
Uncalled bet (168,543) returned to 9feeaa16
9feeaa16: shows [Qh Ks]
b11600f1: shows [As 4h]
*** FLOP *** [7d Jc Qd]
*** TURN *** [7d Jc Qd] [7h]
*** RIVER *** [7d Jc Qd 7h] [3s]
*** SHOWDOWN ***
9feeaa16 collected 966,014 from pot
*** SUMMARY ***
Total pot 966,014 | Rake 0 | Jackpot 0 | Bingo 0 | Fortune 0 | Tax 0
Board [7d Jc Qd 7h 3s]
Seat 1: b81c9328 folded before Flop
Seat 2: 9feeaa16 showed [Qh Ks] and won (966,014) with Pair of Queens and Pair of Sevens
Seat 3: dd346f3c (button) folded before Flop
Seat 4: b1f1b8dc (small blind) folded before Flop
Seat 5: b11600f1 (big blind) showed [As 4h] and lost with Pair of Sevens
Seat 6: Hero folded before Flop


Poker Hand #TM4180648512: Tournament #187165250, Mini Hypersonic $2.50 Hold'em No Limit - Level37(25,000/50,000) - 2025/02/03 18:28:06
Table '40' 6-max Seat #2 is the button
Seat 1: b81c9328 (443,944 in chips)
Seat 2: 9feeaa16 (631,550 in chips)
Seat 3: dd346f3c (276,096 in chips)
Seat 4: b1f1b8dc (1,013,212 in chips)
Seat 5: b11600f1 (463,007 in chips)
Seat 6: Hero (445,200 in chips)
Hero: posts the ante 7,500
b81c9328: posts the ante 7,500
b1f1b8dc: posts the ante 7,500
9feeaa16: posts the ante 7,500
b11600f1: posts the ante 7,500
dd346f3c: posts the ante 7,500
dd346f3c: posts small blind 25,000
b1f1b8dc: posts big blind 50,000
*** HOLE CARDS ***
Dealt to b81c9328 
Dealt to 9feeaa16 
Dealt to dd346f3c 
Dealt to b1f1b8dc 
Dealt to b11600f1 
Dealt to Hero [5c 9h]
b11600f1: folds
Hero: folds
b81c9328: folds
9feeaa16: folds
dd346f3c: folds
Uncalled bet (25,000) returned to b1f1b8dc
*** SHOWDOWN ***
b1f1b8dc collected 95,000 from pot
*** SUMMARY ***
Total pot 95,000 | Rake 0 | Jackpot 0 | Bingo 0 | Fortune 0 | Tax 0
Seat 1: b81c9328 folded before Flop
Seat 2: 9feeaa16 (button) folded before Flop
Seat 3: dd346f3c (small blind) folded before Flop
Seat 4: b1f1b8dc (big blind) collected (95,000)
Seat 5: b11600f1 folded before Flop
Seat 6: Hero folded before Flop


Poker Hand #TM4180648498: Tournament #187165250, Mini Hypersonic $2.50 Hold'em No Limit - Level37(25,000/50,000) - 2025/02/03 18:27:50
Table '40' 6-max Seat #1 is the button
Seat 1: b81c9328 (331,444 in chips)
Seat 2: 9feeaa16 (664,050 in chips)
Seat 3: dd346f3c (333,596 in chips)
Seat 4: b1f1b8dc (1,020,712 in chips)
Seat 5: b11600f1 (470,507 in chips)
Seat 6: Hero (452,700 in chips)
Hero: posts the ante 7,500
b81c9328: posts the ante 7,500
b1f1b8dc: posts the ante 7,500
9feeaa16: posts the ante 7,500
b11600f1: posts the ante 7,500
dd346f3c: posts the ante 7,500
9feeaa16: posts small blind 25,000
dd346f3c: posts big blind 50,000
*** HOLE CARDS ***
Dealt to b81c9328 
Dealt to 9feeaa16 
Dealt to dd346f3c 
Dealt to b1f1b8dc 
Dealt to b11600f1 
Dealt to Hero [9s Ts]
b1f1b8dc: folds
b11600f1: folds
Hero: folds
b81c9328: raises 273,944 to 323,944 and is all-in
9feeaa16: folds
dd346f3c: folds
Uncalled bet (273,944) returned to b81c9328
*** SHOWDOWN ***
b81c9328 collected 170,000 from pot
*** SUMMARY ***
Total pot 170,000 | Rake 0 | Jackpot 0 | Bingo 0 | Fortune 0 | Tax 0
Seat 1: b81c9328 (button) collected (170,000)
Seat 2: 9feeaa16 (small blind) folded before Flop
Seat 3: dd346f3c (big blind) folded before Flop
Seat 4: b1f1b8dc folded before Flop
Seat 5: b11600f1 folded before Flop
Seat 6: Hero folded before Flop


Poker Hand #TM4180648489: Tournament #187165250, Mini Hypersonic $2.50 Hold'em No Limit - Level37(25,000/50,000) - 2025/02/03 18:27:35
Table '40' 6-max Seat #6 is the button
Seat 1: b81c9328 (363,944 in chips)
Seat 2: 9feeaa16 (601,550 in chips)
Seat 3: dd346f3c (341,096 in chips)
Seat 4: b1f1b8dc (1,028,212 in chips)
Seat 5: b11600f1 (478,007 in chips)
Seat 6: Hero (460,200 in chips)
Hero: posts the ante 7,500
b81c9328: posts the ante 7,500
b1f1b8dc: posts the ante 7,500
9feeaa16: posts the ante 7,500
b11600f1: posts the ante 7,500
dd346f3c: posts the ante 7,500
b81c9328: posts small blind 25,000
9feeaa16: posts big blind 50,000
*** HOLE CARDS ***
Dealt to b81c9328 
Dealt to 9feeaa16 
Dealt to dd346f3c 
Dealt to b1f1b8dc 
Dealt to b11600f1 
Dealt to Hero [8c 6s]
dd346f3c: folds
b1f1b8dc: folds
b11600f1: folds
Hero: folds
b81c9328: folds
Uncalled bet (25,000) returned to 9feeaa16
*** SHOWDOWN ***
9feeaa16 collected 95,000 from pot
*** SUMMARY ***
Total pot 95,000 | Rake 0 | Jackpot 0 | Bingo 0 | Fortune 0 | Tax 0
Seat 1: b81c9328 (small blind) folded before Flop
Seat 2: 9feeaa16 (big blind) collected (95,000)
Seat 3: dd346f3c folded before Flop
Seat 4: b1f1b8dc folded before Flop
Seat 5: b11600f1 folded before Flop
Seat 6: Hero (button) folded before Flop


Poker Hand #TM4180648474: Tournament #187165250, Mini Hypersonic $2.50 Hold'em No Limit - Level37(25,000/50,000) - 2025/02/03 18:27:20
Table '40' 6-max Seat #5 is the button
Seat 1: b81c9328 (421,444 in chips)
Seat 2: 9feeaa16 (489,050 in chips)
Seat 3: dd346f3c (348,596 in chips)
Seat 4: b1f1b8dc (1,035,712 in chips)
Seat 5: b11600f1 (485,507 in chips)
Seat 6: Hero (492,700 in chips)
Hero: posts the ante 7,500
b81c9328: posts the ante 7,500
b1f1b8dc: posts the ante 7,500
9feeaa16: posts the ante 7,500
b11600f1: posts the ante 7,500
dd346f3c: posts the ante 7,500
Hero: posts small blind 25,000
b81c9328: posts big blind 50,000
*** HOLE CARDS ***
Dealt to b81c9328 
Dealt to 9feeaa16 
Dealt to dd346f3c 
Dealt to b1f1b8dc 
Dealt to b11600f1 
Dealt to Hero [5h Kd]
9feeaa16: raises 431,550 to 481,550 and is all-in
dd346f3c: folds
b1f1b8dc: folds
b11600f1: folds
Hero: folds
b81c9328: folds
Uncalled bet (431,550) returned to 9feeaa16
*** SHOWDOWN ***
9feeaa16 collected 170,000 from pot
*** SUMMARY ***
Total pot 170,000 | Rake 0 | Jackpot 0 | Bingo 0 | Fortune 0 | Tax 0
Seat 1: b81c9328 (big blind) folded before Flop
Seat 2: 9feeaa16 collected (170,000)
Seat 3: dd346f3c folded before Flop
Seat 4: b1f1b8dc folded before Flop
Seat 5: b11600f1 (button) folded before Flop
Seat 6: Hero (small blind) folded before Flop


Poker Hand #TM4180648459: Tournament #187165250, Mini Hypersonic $2.50 Hold'em No Limit - Level36(20,000/40,000) - 2025/02/03 18:26:54
Table '40' 6-max Seat #4 is the button
Seat 1: b81c9328 (427,444 in chips)
Seat 2: 9feeaa16 (399,050 in chips)
Seat 3: dd346f3c (354,596 in chips)
Seat 4: b1f1b8dc (1,041,712 in chips)
Seat 5: b11600f1 (511,507 in chips)
Seat 6: Hero (538,700 in chips)
Hero: posts the ante 6,000
b81c9328: posts the ante 6,000
b1f1b8dc: posts the ante 6,000
9feeaa16: posts the ante 6,000
dd346f3c: posts the ante 6,000
b11600f1: posts the ante 6,000
b11600f1: posts small blind 20,000
Hero: posts big blind 40,000
*** HOLE CARDS ***
Dealt to b81c9328 
Dealt to 9feeaa16 
Dealt to dd346f3c 
Dealt to b1f1b8dc 
Dealt to b11600f1 
Dealt to Hero [6d Kh]
b81c9328: folds
9feeaa16: raises 353,050 to 393,050 and is all-in
dd346f3c: folds
b1f1b8dc: folds
b11600f1: folds
Hero: folds
Uncalled bet (353,050) returned to 9feeaa16
*** SHOWDOWN ***
9feeaa16 collected 136,000 from pot
*** SUMMARY ***
Total pot 136,000 | Rake 0 | Jackpot 0 | Bingo 0 | Fortune 0 | Tax 0
Seat 1: b81c9328 folded before Flop
Seat 2: 9feeaa16 collected (136,000)
Seat 3: dd346f3c folded before Flop
Seat 4: b1f1b8dc (button) folded before Flop
Seat 5: b11600f1 (small blind) folded before Flop
Seat 6: Hero (big blind) folded before Flop


Poker Hand #TM4180648426: Tournament #187165250, Mini Hypersonic $2.50 Hold'em No Limit - Level36(20,000/40,000) - 2025/02/03 18:26:19
Table '40' 6-max Seat #3 is the button
Seat 1: b81c9328 (433,444 in chips)
Seat 2: 9feeaa16 (887,906 in chips)
Seat 3: dd346f3c (360,596 in chips)
Seat 4: b1f1b8dc (488,856 in chips)
Seat 5: b11600f1 (557,507 in chips)
Seat 6: Hero (544,700 in chips)
Hero: posts the ante 6,000
b81c9328: posts the ante 6,000
b1f1b8dc: posts the ante 6,000
9feeaa16: posts the ante 6,000
dd346f3c: posts the ante 6,000
b11600f1: posts the ante 6,000
b1f1b8dc: posts small blind 20,000
b11600f1: posts big blind 40,000
*** HOLE CARDS ***
Dealt to b81c9328 
Dealt to 9feeaa16 
Dealt to dd346f3c 
Dealt to b1f1b8dc 
Dealt to b11600f1 
Dealt to Hero [6d Qc]
Hero: folds
b81c9328: folds
9feeaa16: raises 841,906 to 881,906 and is all-in
dd346f3c: folds
b1f1b8dc: calls 462,856 and is all-in
b11600f1: folds
Uncalled bet (399,050) returned to 9feeaa16
9feeaa16: shows [Td As]
b1f1b8dc: shows [7h 7c]
*** FLOP *** [5c 4s 6h]
*** TURN *** [5c 4s 6h] [8h]
*** RIVER *** [5c 4s 6h 8h] [2c]
*** SHOWDOWN ***
b1f1b8dc collected 1,041,712 from pot
*** SUMMARY ***
Total pot 1,041,712 | Rake 0 | Jackpot 0 | Bingo 0 | Fortune 0 | Tax 0
Board [5c 4s 6h 8h 2c]
Seat 1: b81c9328 folded before Flop
Seat 2: 9feeaa16 showed [Td As] and lost with Ace-High
Seat 3: dd346f3c (button) folded before Flop
Seat 4: b1f1b8dc (small blind) showed [7h 7c] and won (1,041,712) with Eights-High Straight
Seat 5: b11600f1 (big blind) folded before Flop
Seat 6: Hero folded before Flop


Poker Hand #TM4180648408: Tournament #187165250, Mini Hypersonic $2.50 Hold'em No Limit - Level36(20,000/40,000) - 2025/02/03 18:25:54
Table '40' 6-max Seat #2 is the button
Seat 1: b81c9328 (439,444 in chips)
Seat 2: 9feeaa16 (893,906 in chips)
Seat 3: dd346f3c (406,596 in chips)
Seat 4: b1f1b8dc (418,856 in chips)
Seat 5: b11600f1 (563,507 in chips)
Seat 6: Hero (550,700 in chips)
Hero: posts the ante 6,000
b81c9328: posts the ante 6,000
b1f1b8dc: posts the ante 6,000
9feeaa16: posts the ante 6,000
b11600f1: posts the ante 6,000
dd346f3c: posts the ante 6,000
dd346f3c: posts small blind 20,000
b1f1b8dc: posts big blind 40,000
*** HOLE CARDS ***
Dealt to b81c9328 
Dealt to 9feeaa16 
Dealt to dd346f3c 
Dealt to b1f1b8dc 
Dealt to b11600f1 
Dealt to Hero [Js 7d]
b11600f1: folds
Hero: folds
b81c9328: folds
9feeaa16: folds
dd346f3c: calls 20,000
b1f1b8dc: checks
*** FLOP *** [5d 4d Jh]
dd346f3c: checks
b1f1b8dc: bets 60,000
dd346f3c: folds
Uncalled bet (60,000) returned to b1f1b8dc
*** SHOWDOWN ***
b1f1b8dc collected 116,000 from pot
*** SUMMARY ***
Total pot 116,000 | Rake 0 | Jackpot 0 | Bingo 0 | Fortune 0 | Tax 0
Board [5d 4d Jh]
Seat 1: b81c9328 folded before Flop
Seat 2: 9feeaa16 (button) folded before Flop
Seat 3: dd346f3c (small blind) folded on the Flop
Seat 4: b1f1b8dc (big blind) won (116,000)
Seat 5: b11600f1 folded before Flop
Seat 6: Hero folded before Flop


Poker Hand #TM4180648374: Tournament #187165250, Mini Hypersonic $2.50 Hold'em No Limit - Level36(20,000/40,000) - 2025/02/03 18:25:00
Table '40' 6-max Seat #1 is the button
Seat 1: b81c9328 (445,444 in chips)
Seat 2: 9feeaa16 (414,953 in chips)
Seat 3: dd346f3c (452,596 in chips)
Seat 4: b1f1b8dc (424,856 in chips)
Seat 5: b11600f1 (978,460 in chips)
Seat 6: Hero (556,700 in chips)
Hero: posts the ante 6,000
b81c9328: posts the ante 6,000
b1f1b8dc: posts the ante 6,000
9feeaa16: posts the ante 6,000
b11600f1: posts the ante 6,000
dd346f3c: posts the ante 6,000
9feeaa16: posts small blind 20,000
dd346f3c: posts big blind 40,000
*** HOLE CARDS ***
Dealt to b81c9328 
Dealt to 9feeaa16 
Dealt to dd346f3c 
Dealt to b1f1b8dc 
Dealt to b11600f1 
Dealt to Hero [3c 8s]
b1f1b8dc: folds
b11600f1: raises 48,000 to 88,000
Hero: folds
b81c9328: folds
9feeaa16: raises 320,953 to 408,953 and is all-in
dd346f3c: folds
b11600f1: calls 320,953
9feeaa16: shows [Kd Ac]
b11600f1: shows [Ah 9s]
*** FLOP *** [6d 7s 3h]
*** TURN *** [6d 7s 3h] [Qc]
*** RIVER *** [6d 7s 3h Qc] [Td]
b81c9328: shows [Ts] (Pair of Tens)
*** SHOWDOWN ***
9feeaa16 collected 893,906 from pot
*** SUMMARY ***
Total pot 893,906 | Rake 0 | Jackpot 0 | Bingo 0 | Fortune 0 | Tax 0
Board [6d 7s 3h Qc Td]
Seat 1: b81c9328 (button) folded before Flop
Seat 2: 9feeaa16 (small blind) showed [Kd Ac] and won (893,906) with Ace-High
Seat 3: dd346f3c (big blind) folded before Flop
Seat 4: b1f1b8dc folded before Flop
Seat 5: b11600f1 showed [Ah 9s] and lost with Ace-High
Seat 6: Hero folded before Flop


Poker Hand #TM4180648325: Tournament #187165250, Mini Hypersonic $2.50 Hold'em No Limit - Level36(20,000/40,000) - 2025/02/03 18:23:52
Table '40' 6-max Seat #6 is the button
Seat 1: b81c9328 (471,444 in chips)
Seat 2: 9feeaa16 (460,953 in chips)
Seat 3: dd346f3c (458,596 in chips)
Seat 5: b11600f1 (984,460 in chips)
Seat 6: Hero (472,700 in chips)
Hero: posts the ante 6,000
b81c9328: posts the ante 6,000
9feeaa16: posts the ante 6,000
b11600f1: posts the ante 6,000
dd346f3c: posts the ante 6,000
b81c9328: posts small blind 20,000
9feeaa16: posts big blind 40,000
*** HOLE CARDS ***
Dealt to b81c9328 
Dealt to 9feeaa16 
Dealt to dd346f3c 
Dealt to b11600f1 
Dealt to Hero [Ah 5h]
dd346f3c: folds
b11600f1: folds
Hero: raises 426,700 to 466,700 and is all-in
b81c9328: folds
9feeaa16: folds
Uncalled bet (426,700) returned to Hero
*** SHOWDOWN ***
Hero collected 130,000 from pot
*** SUMMARY ***
Total pot 130,000 | Rake 0 | Jackpot 0 | Bingo 0 | Fortune 0 | Tax 0
Seat 1: b81c9328 (small blind) folded before Flop
Seat 2: 9feeaa16 (big blind) folded before Flop
Seat 3: dd346f3c folded before Flop
Seat 5: b11600f1 folded before Flop
Seat 6: Hero (button) collected (130,000)


Poker Hand #TM4180648316: Tournament #187165250, Mini Hypersonic $2.50 Hold'em No Limit - Level36(20,000/40,000) - 2025/02/03 18:23:37
Table '40' 6-max Seat #5 is the button
Seat 1: b81c9328 (427,444 in chips)
Seat 2: 9feeaa16 (466,953 in chips)
Seat 3: dd346f3c (464,596 in chips)
Seat 5: b11600f1 (990,460 in chips)
Seat 6: Hero (498,700 in chips)
Hero: posts the ante 6,000
b81c9328: posts the ante 6,000
9feeaa16: posts the ante 6,000
b11600f1: posts the ante 6,000
dd346f3c: posts the ante 6,000
Hero: posts small blind 20,000
b81c9328: posts big blind 40,000
*** HOLE CARDS ***
Dealt to b81c9328 
Dealt to 9feeaa16 
Dealt to dd346f3c 
Dealt to b11600f1 
Dealt to Hero [3d 2h]
9feeaa16: folds
dd346f3c: folds
b11600f1: folds
Hero: folds
Uncalled bet (20,000) returned to b81c9328
*** SHOWDOWN ***
b81c9328 collected 70,000 from pot
*** SUMMARY ***
Total pot 70,000 | Rake 0 | Jackpot 0 | Bingo 0 | Fortune 0 | Tax 0
Seat 1: b81c9328 (big blind) collected (70,000)
Seat 2: 9feeaa16 folded before Flop
Seat 3: dd346f3c folded before Flop
Seat 5: b11600f1 (button) folded before Flop
Seat 6: Hero (small blind) folded before Flop


Poker Hand #TM4180648283: Tournament #187165250, Mini Hypersonic $2.50 Hold'em No Limit - Level35(17,500/35,000) - 2025/02/03 18:22:50
Table '40' 6-max Seat #3 is the button
Seat 1: b81c9328 (432,444 in chips)
Seat 2: 9feeaa16 (471,953 in chips)
Seat 3: dd346f3c (469,596 in chips)
Seat 5: b11600f1 (865,460 in chips)
Seat 6: Hero (608,700 in chips)
Hero: posts the ante 5,000
b81c9328: posts the ante 5,000
9feeaa16: posts the ante 5,000
dd346f3c: posts the ante 5,000
b11600f1: posts the ante 5,000
b11600f1: posts small blind 17,500
Hero: posts big blind 35,000
*** HOLE CARDS ***
Dealt to b81c9328 
Dealt to 9feeaa16 
Dealt to dd346f3c 
Dealt to b11600f1 
Dealt to Hero [7h Jh]
b81c9328: folds
9feeaa16: folds
dd346f3c: folds
b11600f1: raises 70,000 to 105,000
Hero: calls 70,000
*** FLOP *** [3c 2c Ks]
b11600f1: bets 77,550
Hero: folds
Uncalled bet (77,550) returned to b11600f1
*** SHOWDOWN ***
b11600f1 collected 235,000 from pot
*** SUMMARY ***
Total pot 235,000 | Rake 0 | Jackpot 0 | Bingo 0 | Fortune 0 | Tax 0
Board [3c 2c Ks]
Seat 1: b81c9328 folded before Flop
Seat 2: 9feeaa16 folded before Flop
Seat 3: dd346f3c (button) folded before Flop
Seat 5: b11600f1 (small blind) won (235,000)
Seat 6: Hero (big blind) folded on the Flop


Poker Hand #TM4180648273: Tournament #187165250, Mini Hypersonic $2.50 Hold'em No Limit - Level35(17,500/35,000) - 2025/02/03 18:22:36
Table '40' 6-max Seat #2 is the button
Seat 1: b81c9328 (437,444 in chips)
Seat 2: 9feeaa16 (399,453 in chips)
Seat 3: dd346f3c (492,096 in chips)
Seat 5: b11600f1 (905,460 in chips)
Seat 6: Hero (613,700 in chips)
Hero: posts the ante 5,000
b81c9328: posts the ante 5,000
9feeaa16: posts the ante 5,000
b11600f1: posts the ante 5,000
dd346f3c: posts the ante 5,000
dd346f3c: posts small blind 17,500
b11600f1: posts big blind 35,000
*** HOLE CARDS ***
Dealt to b81c9328 
Dealt to 9feeaa16 
Dealt to dd346f3c 
Dealt to b11600f1 
Dealt to Hero [2c Js]
Hero: folds
b81c9328: folds
9feeaa16: raises 359,453 to 394,453 and is all-in
dd346f3c: folds
b11600f1: folds
Uncalled bet (359,453) returned to 9feeaa16
*** SHOWDOWN ***
9feeaa16 collected 112,500 from pot
*** SUMMARY ***
Total pot 112,500 | Rake 0 | Jackpot 0 | Bingo 0 | Fortune 0 | Tax 0
Seat 1: b81c9328 folded before Flop
Seat 2: 9feeaa16 (button) collected (112,500)
Seat 3: dd346f3c (small blind) folded before Flop
Seat 5: b11600f1 (big blind) folded before Flop
Seat 6: Hero folded before Flop


Poker Hand #TM4180648253: Tournament #187165250, Mini Hypersonic $2.50 Hold'em No Limit - Level35(17,500/35,000) - 2025/02/03 18:22:09
Table '40' 6-max Seat #1 is the button
Seat 1: b81c9328 (364,944 in chips)
Seat 2: 9feeaa16 (421,953 in chips)
Seat 3: dd346f3c (532,096 in chips)
Seat 5: b11600f1 (910,460 in chips)
Seat 6: Hero (618,700 in chips)
Hero: posts the ante 5,000
b81c9328: posts the ante 5,000
9feeaa16: posts the ante 5,000
b11600f1: posts the ante 5,000
dd346f3c: posts the ante 5,000
9feeaa16: posts small blind 17,500
dd346f3c: posts big blind 35,000
*** HOLE CARDS ***
Dealt to b81c9328 
Dealt to 9feeaa16 
Dealt to dd346f3c 
Dealt to b11600f1 
Dealt to Hero [3d 8s]
b11600f1: folds
Hero: folds
b81c9328: raises 38,500 to 73,500
9feeaa16: folds
dd346f3c: folds
Uncalled bet (38,500) returned to b81c9328
*** SHOWDOWN ***
b81c9328 collected 112,500 from pot
*** SUMMARY ***
Total pot 112,500 | Rake 0 | Jackpot 0 | Bingo 0 | Fortune 0 | Tax 0
Seat 1: b81c9328 (button) collected (112,500)
Seat 2: 9feeaa16 (small blind) folded before Flop
Seat 3: dd346f3c (big blind) folded before Flop
Seat 5: b11600f1 folded before Flop
Seat 6: Hero folded before Flop


Poker Hand #TM4180648233: Tournament #187165250, Mini Hypersonic $2.50 Hold'em No Limit - Level35(17,500/35,000) - 2025/02/03 18:21:46
Table '40' 6-max Seat #6 is the button
Seat 1: b81c9328 (387,444 in chips)
Seat 2: 9feeaa16 (461,953 in chips)
Seat 3: dd346f3c (459,596 in chips)
Seat 5: b11600f1 (915,460 in chips)
Seat 6: Hero (623,700 in chips)
Hero: posts the ante 5,000
b81c9328: posts the ante 5,000
9feeaa16: posts the ante 5,000
b11600f1: posts the ante 5,000
dd346f3c: posts the ante 5,000
b81c9328: posts small blind 17,500
9feeaa16: posts big blind 35,000
*** HOLE CARDS ***
Dealt to b81c9328 
Dealt to 9feeaa16 
Dealt to dd346f3c 
Dealt to b11600f1 
Dealt to Hero [8d As]
dd346f3c: raises 35,000 to 70,000
b11600f1: folds
Hero: folds
b81c9328: folds
9feeaa16: folds
Uncalled bet (35,000) returned to dd346f3c
*** SHOWDOWN ***
dd346f3c collected 112,500 from pot
*** SUMMARY ***
Total pot 112,500 | Rake 0 | Jackpot 0 | Bingo 0 | Fortune 0 | Tax 0
Seat 1: b81c9328 (small blind) folded before Flop
Seat 2: 9feeaa16 (big blind) folded before Flop
Seat 3: dd346f3c collected (112,500)
Seat 5: b11600f1 folded before Flop
Seat 6: Hero (button) folded before Flop


Poker Hand #TM4180648221: Tournament #187165250, Mini Hypersonic $2.50 Hold'em No Limit - Level35(17,500/35,000) - 2025/02/03 18:21:31
Table '40' 6-max Seat #5 is the button
Seat 1: b81c9328 (427,444 in chips)
Seat 2: 9feeaa16 (389,453 in chips)
Seat 3: dd346f3c (464,596 in chips)
Seat 5: b11600f1 (920,460 in chips)
Seat 6: Hero (646,200 in chips)
Hero: posts the ante 5,000
b81c9328: posts the ante 5,000
9feeaa16: posts the ante 5,000
b11600f1: posts the ante 5,000
dd346f3c: posts the ante 5,000
Hero: posts small blind 17,500
b81c9328: posts big blind 35,000
*** HOLE CARDS ***
Dealt to b81c9328 
Dealt to 9feeaa16 
Dealt to dd346f3c 
Dealt to b11600f1 
Dealt to Hero [3h 8s]
9feeaa16: raises 349,453 to 384,453 and is all-in
dd346f3c: folds
b11600f1: folds
Hero: folds
b81c9328: folds
Uncalled bet (349,453) returned to 9feeaa16
*** SHOWDOWN ***
9feeaa16 collected 112,500 from pot
*** SUMMARY ***
Total pot 112,500 | Rake 0 | Jackpot 0 | Bingo 0 | Fortune 0 | Tax 0
Seat 1: b81c9328 (big blind) folded before Flop
Seat 2: 9feeaa16 collected (112,500)
Seat 3: dd346f3c folded before Flop
Seat 5: b11600f1 (button) folded before Flop
Seat 6: Hero (small blind) folded before Flop


Poker Hand #TM4180648213: Tournament #187165250, Mini Hypersonic $2.50 Hold'em No Limit - Level35(17,500/35,000) - 2025/02/03 18:21:18
Table '40' 6-max Seat #3 is the button
Seat 1: b81c9328 (432,444 in chips)
Seat 2: 9feeaa16 (394,453 in chips)
Seat 3: dd346f3c (469,596 in chips)
Seat 5: b11600f1 (942,960 in chips)
Seat 6: Hero (608,700 in chips)
Hero: posts the ante 5,000
b81c9328: posts the ante 5,000
9feeaa16: posts the ante 5,000
dd346f3c: posts the ante 5,000
b11600f1: posts the ante 5,000
b11600f1: posts small blind 17,500
Hero: posts big blind 35,000
*** HOLE CARDS ***
Dealt to b81c9328 
Dealt to 9feeaa16 
Dealt to dd346f3c 
Dealt to b11600f1 
Dealt to Hero [As 6s]
b81c9328: folds
9feeaa16: folds
dd346f3c: folds
b11600f1: folds
Uncalled bet (17,500) returned to Hero
*** SHOWDOWN ***
Hero collected 60,000 from pot
*** SUMMARY ***
Total pot 60,000 | Rake 0 | Jackpot 0 | Bingo 0 | Fortune 0 | Tax 0
Seat 1: b81c9328 folded before Flop
Seat 2: 9feeaa16 folded before Flop
Seat 3: dd346f3c (button) folded before Flop
Seat 5: b11600f1 (small blind) folded before Flop
Seat 6: Hero (big blind) collected (60,000)


Poker Hand #TM4180648206: Tournament #187165250, Mini Hypersonic $2.50 Hold'em No Limit - Level35(17,500/35,000) - 2025/02/03 18:21:05
Table '40' 6-max Seat #2 is the button
Seat 1: b81c9328 (437,444 in chips)
Seat 2: 9feeaa16 (399,453 in chips)
Seat 3: dd346f3c (492,096 in chips)
Seat 5: b11600f1 (905,460 in chips)
Seat 6: Hero (613,700 in chips)
Hero: posts the ante 5,000
b81c9328: posts the ante 5,000
9feeaa16: posts the ante 5,000
b11600f1: posts the ante 5,000
dd346f3c: posts the ante 5,000
dd346f3c: posts small blind 17,500
b11600f1: posts big blind 35,000
*** HOLE CARDS ***
Dealt to b81c9328 
Dealt to 9feeaa16 
Dealt to dd346f3c 
Dealt to b11600f1 
Dealt to Hero [9d 7s]
Hero: folds
b81c9328: folds
9feeaa16: folds
dd346f3c: folds
Uncalled bet (17,500) returned to b11600f1
*** SHOWDOWN ***
b11600f1 collected 60,000 from pot
*** SUMMARY ***
Total pot 60,000 | Rake 0 | Jackpot 0 | Bingo 0 | Fortune 0 | Tax 0
Seat 1: b81c9328 folded before Flop
Seat 2: 9feeaa16 (button) folded before Flop
Seat 3: dd346f3c (small blind) folded before Flop
Seat 5: b11600f1 (big blind) collected (60,000)
Seat 6: Hero folded before Flop


Poker Hand #TM4180648184: Tournament #187165250, Mini Hypersonic $2.50 Hold'em No Limit - Level35(17,500/35,000) - 2025/02/03 18:20:40
Table '40' 6-max Seat #1 is the button
Seat 1: b81c9328 (442,444 in chips)
Seat 2: 9feeaa16 (344,453 in chips)
Seat 3: dd346f3c (532,096 in chips)
Seat 5: b11600f1 (910,460 in chips)
Seat 6: Hero (618,700 in chips)
Hero: posts the ante 5,000
b81c9328: posts the ante 5,000
9feeaa16: posts the ante 5,000
b11600f1: posts the ante 5,000
dd346f3c: posts the ante 5,000
9feeaa16: posts small blind 17,500
dd346f3c: posts big blind 35,000
*** HOLE CARDS ***
Dealt to b81c9328 
Dealt to 9feeaa16 
Dealt to dd346f3c 
Dealt to b11600f1 
Dealt to Hero [Kh 8s]
b11600f1: folds
Hero: folds
b81c9328: folds
9feeaa16: raises 304,453 to 339,453 and is all-in
dd346f3c: folds
Uncalled bet (304,453) returned to 9feeaa16
*** SHOWDOWN ***
9feeaa16 collected 95,000 from pot
*** SUMMARY ***
Total pot 95,000 | Rake 0 | Jackpot 0 | Bingo 0 | Fortune 0 | Tax 0
Seat 1: b81c9328 (button) folded before Flop
Seat 2: 9feeaa16 (small blind) collected (95,000)
Seat 3: dd346f3c (big blind) folded before Flop
Seat 5: b11600f1 folded before Flop
Seat 6: Hero folded before Flop


Poker Hand #TM4180648158: Tournament #187165250, Mini Hypersonic $2.50 Hold'em No Limit - Level35(17,500/35,000) - 2025/02/03 18:20:05
Table '40' 6-max Seat #6 is the button
Seat 1: b81c9328 (464,944 in chips)
Seat 2: 9feeaa16 (289,821 in chips)
Seat 3: dd346f3c (537,096 in chips)
Seat 4: 182dd106 (17,132 in chips)
Seat 5: b11600f1 (915,460 in chips)
Seat 6: Hero (623,700 in chips)
Hero: posts the ante 5,000
b81c9328: posts the ante 5,000
182dd106: posts the ante 5,000
9feeaa16: posts the ante 5,000
b11600f1: posts the ante 5,000
dd346f3c: posts the ante 5,000
b81c9328: posts small blind 17,500
9feeaa16: posts big blind 35,000
*** HOLE CARDS ***
Dealt to b81c9328 
Dealt to 9feeaa16 
Dealt to dd346f3c 
Dealt to 182dd106 
Dealt to b11600f1 
Dealt to Hero [5d Kd]
dd346f3c: folds
182dd106: calls 12,132 and is all-in
b11600f1: folds
Hero: folds
b81c9328: folds
Uncalled bet (17,500) returned to 9feeaa16
9feeaa16: shows [4c Ks]
182dd106: shows [7c 5s]
*** FLOP *** [7h 2s Kh]
*** TURN *** [7h 2s Kh] [Qc]
*** RIVER *** [7h 2s Kh Qc] [4h]
*** SHOWDOWN ***
9feeaa16 collected 66,396 from pot
9feeaa16 collected 10,736 from pot
*** SUMMARY ***
Total pot 77,132 | Rake 0 | Jackpot 0 | Bingo 0 | Fortune 0 | Tax 0
Board [7h 2s Kh Qc 4h]
Seat 1: b81c9328 (small blind) folded before Flop
Seat 2: 9feeaa16 (big blind) showed [4c Ks] and won (77,132) with Pair of Kings and Pair of Fours
Seat 3: dd346f3c folded before Flop
Seat 4: 182dd106 showed [7c 5s] and lost with Pair of Sevens
Seat 5: b11600f1 folded before Flop
Seat 6: Hero (button) folded before Flop


Poker Hand #TM4180648127: Tournament #187165250, Mini Hypersonic $2.50 Hold'em No Limit - Level35(17,500/35,000) - 2025/02/03 18:19:28
Table '40' 6-max Seat #5 is the button
Seat 1: b81c9328 (504,944 in chips)
Seat 2: 9feeaa16 (294,821 in chips)
Seat 3: dd346f3c (542,096 in chips)
Seat 4: 182dd106 (438,612 in chips)
Seat 5: b11600f1 (421,480 in chips)
Seat 6: Hero (646,200 in chips)
Hero: posts the ante 5,000
b81c9328: posts the ante 5,000
182dd106: posts the ante 5,000
9feeaa16: posts the ante 5,000
b11600f1: posts the ante 5,000
dd346f3c: posts the ante 5,000
Hero: posts small blind 17,500
b81c9328: posts big blind 35,000
*** HOLE CARDS ***
Dealt to b81c9328 
Dealt to 9feeaa16 
Dealt to dd346f3c 
Dealt to 182dd106 
Dealt to b11600f1 
Dealt to Hero [2d 7s]
9feeaa16: folds
dd346f3c: folds
182dd106: raises 398,612 to 433,612 and is all-in
b11600f1: calls 416,480 and is all-in
Hero: folds
b81c9328: folds
Uncalled bet (17,132) returned to 182dd106
182dd106: shows [As Jh]
b11600f1: shows [Qh Ah]
*** FLOP *** [4h 5h 3d]
*** TURN *** [4h 5h 3d] [9h]
*** RIVER *** [4h 5h 3d 9h] [7c]
*** SHOWDOWN ***
b11600f1 collected 915,460 from pot
*** SUMMARY ***
Total pot 915,460 | Rake 0 | Jackpot 0 | Bingo 0 | Fortune 0 | Tax 0
Board [4h 5h 3d 9h 7c]
Seat 1: b81c9328 (big blind) folded before Flop
Seat 2: 9feeaa16 folded before Flop
Seat 3: dd346f3c folded before Flop
Seat 4: 182dd106 showed [As Jh] and lost with Ace-High
Seat 5: b11600f1 (button) showed [Qh Ah] and won (915,460) with Ace High Flush
Seat 6: Hero (small blind) folded before Flop


Poker Hand #TM4180648112: Tournament #187165250, Mini Hypersonic $2.50 Hold'em No Limit - Level35(17,500/35,000) - 2025/02/03 18:19:10
Table '40' 6-max Seat #4 is the button
Seat 1: b81c9328 (509,944 in chips)
Seat 2: 9feeaa16 (299,821 in chips)
Seat 3: dd346f3c (547,096 in chips)
Seat 4: 182dd106 (443,612 in chips)
Seat 5: b11600f1 (443,980 in chips)
Seat 6: Hero (603,700 in chips)
Hero: posts the ante 5,000
b81c9328: posts the ante 5,000
182dd106: posts the ante 5,000
9feeaa16: posts the ante 5,000
dd346f3c: posts the ante 5,000
b11600f1: posts the ante 5,000
b11600f1: posts small blind 17,500
Hero: posts big blind 35,000
*** HOLE CARDS ***
Dealt to b81c9328 
Dealt to 9feeaa16 
Dealt to dd346f3c 
Dealt to 182dd106 
Dealt to b11600f1 
Dealt to Hero [Ad 7h]
b81c9328: folds
9feeaa16: folds
dd346f3c: folds
182dd106: folds
b11600f1: folds
Uncalled bet (17,500) returned to Hero
*** SHOWDOWN ***
Hero collected 65,000 from pot
*** SUMMARY ***
Total pot 65,000 | Rake 0 | Jackpot 0 | Bingo 0 | Fortune 0 | Tax 0
Seat 1: b81c9328 folded before Flop
Seat 2: 9feeaa16 folded before Flop
Seat 3: dd346f3c folded before Flop
Seat 4: 182dd106 (button) folded before Flop
Seat 5: b11600f1 (small blind) folded before Flop
Seat 6: Hero (big blind) collected (65,000)


Poker Hand #TM4180648095: Tournament #187165250, Mini Hypersonic $2.50 Hold'em No Limit - Level34(15,000/30,000) - 2025/02/03 18:18:49
Table '40' 6-max Seat #3 is the button
Seat 1: b81c9328 (514,444 in chips)
Seat 2: 9feeaa16 (304,321 in chips)
Seat 3: dd346f3c (551,596 in chips)
Seat 4: 182dd106 (463,112 in chips)
Seat 5: b11600f1 (406,480 in chips)
Seat 6: Hero (608,200 in chips)
Hero: posts the ante 4,500
b81c9328: posts the ante 4,500
182dd106: posts the ante 4,500
9feeaa16: posts the ante 4,500
dd346f3c: posts the ante 4,500
b11600f1: posts the ante 4,500
182dd106: posts small blind 15,000
b11600f1: posts big blind 30,000
*** HOLE CARDS ***
Dealt to b81c9328 
Dealt to 9feeaa16 
Dealt to dd346f3c 
Dealt to 182dd106 
Dealt to b11600f1 
Dealt to Hero [9s 5h]
Hero: folds
b81c9328: folds
9feeaa16: folds
dd346f3c: folds
182dd106: folds
Uncalled bet (15,000) returned to b11600f1
*** SHOWDOWN ***
b11600f1 collected 57,000 from pot
*** SUMMARY ***
Total pot 57,000 | Rake 0 | Jackpot 0 | Bingo 0 | Fortune 0 | Tax 0
Seat 1: b81c9328 folded before Flop
Seat 2: 9feeaa16 folded before Flop
Seat 3: dd346f3c (button) folded before Flop
Seat 4: 182dd106 (small blind) folded before Flop
Seat 5: b11600f1 (big blind) collected (57,000)
Seat 6: Hero folded before Flop


Poker Hand #TM4180648081: Tournament #187165250, Mini Hypersonic $2.50 Hold'em No Limit - Level34(15,000/30,000) - 2025/02/03 18:18:25
Table '40' 6-max Seat #2 is the button
Seat 1: b81c9328 (446,944 in chips)
Seat 2: 9feeaa16 (308,821 in chips)
Seat 3: dd346f3c (571,096 in chips)
Seat 4: 182dd106 (497,612 in chips)
Seat 5: b11600f1 (410,980 in chips)
Seat 6: Hero (612,700 in chips)
Hero: posts the ante 4,500
b81c9328: posts the ante 4,500
182dd106: posts the ante 4,500
9feeaa16: posts the ante 4,500
b11600f1: posts the ante 4,500
dd346f3c: posts the ante 4,500
dd346f3c: posts small blind 15,000
182dd106: posts big blind 30,000
*** HOLE CARDS ***
Dealt to b81c9328 
Dealt to 9feeaa16 
Dealt to dd346f3c 
Dealt to 182dd106 
Dealt to b11600f1 
Dealt to Hero [9s Kh]
b11600f1: folds
Hero: folds
b81c9328: raises 33,000 to 63,000
9feeaa16: folds
dd346f3c: folds
182dd106: folds
Uncalled bet (33,000) returned to b81c9328
*** SHOWDOWN ***
b81c9328 collected 102,000 from pot
*** SUMMARY ***
Total pot 102,000 | Rake 0 | Jackpot 0 | Bingo 0 | Fortune 0 | Tax 0
Seat 1: b81c9328 collected (102,000)
Seat 2: 9feeaa16 (button) folded before Flop
Seat 3: dd346f3c (small blind) folded before Flop
Seat 4: 182dd106 (big blind) folded before Flop
Seat 5: b11600f1 folded before Flop
Seat 6: Hero folded before Flop


Poker Hand #TM4180648066: Tournament #187165250, Mini Hypersonic $2.50 Hold'em No Limit - Level34(15,000/30,000) - 2025/02/03 18:18:07
Table '40' 6-max Seat #1 is the button
Seat 1: b81c9328 (451,444 in chips)
Seat 2: 9feeaa16 (328,321 in chips)
Seat 3: dd346f3c (533,596 in chips)
Seat 4: 182dd106 (502,112 in chips)
Seat 5: b11600f1 (415,480 in chips)
Seat 6: Hero (617,200 in chips)
Hero: posts the ante 4,500
b81c9328: posts the ante 4,500
182dd106: posts the ante 4,500
9feeaa16: posts the ante 4,500
b11600f1: posts the ante 4,500
dd346f3c: posts the ante 4,500
9feeaa16: posts small blind 15,000
dd346f3c: posts big blind 30,000
*** HOLE CARDS ***
Dealt to b81c9328 
Dealt to 9feeaa16 
Dealt to dd346f3c 
Dealt to 182dd106 
Dealt to b11600f1 
Dealt to Hero [8d 3c]
182dd106: folds
b11600f1: folds
Hero: folds
b81c9328: folds
9feeaa16: folds
Uncalled bet (15,000) returned to dd346f3c
*** SHOWDOWN ***
dd346f3c collected 57,000 from pot
*** SUMMARY ***
Total pot 57,000 | Rake 0 | Jackpot 0 | Bingo 0 | Fortune 0 | Tax 0
Seat 1: b81c9328 (button) folded before Flop
Seat 2: 9feeaa16 (small blind) folded before Flop
Seat 3: dd346f3c (big blind) collected (57,000)
Seat 4: 182dd106 folded before Flop
Seat 5: b11600f1 folded before Flop
Seat 6: Hero folded before Flop


Poker Hand #TM4180648044: Tournament #187165250, Mini Hypersonic $2.50 Hold'em No Limit - Level34(15,000/30,000) - 2025/02/03 18:17:38
Table '40' 6-max Seat #6 is the button
Seat 1: b81c9328 (398,944 in chips)
Seat 2: 9feeaa16 (362,821 in chips)
Seat 3: dd346f3c (538,096 in chips)
Seat 4: 182dd106 (506,612 in chips)
Seat 5: b11600f1 (419,980 in chips)
Seat 6: Hero (621,700 in chips)
Hero: posts the ante 4,500
b81c9328: posts the ante 4,500
182dd106: posts the ante 4,500
9feeaa16: posts the ante 4,500
b11600f1: posts the ante 4,500
dd346f3c: posts the ante 4,500
b81c9328: posts small blind 15,000
9feeaa16: posts big blind 30,000
*** HOLE CARDS ***
Dealt to b81c9328 
Dealt to 9feeaa16 
Dealt to dd346f3c 
Dealt to 182dd106 
Dealt to b11600f1 
Dealt to Hero [3s Jd]
dd346f3c: folds
182dd106: folds
b11600f1: folds
Hero: folds
b81c9328: raises 364,444 to 394,444 and is all-in
9feeaa16: folds
Uncalled bet (364,444) returned to b81c9328
*** SHOWDOWN ***
b81c9328 collected 87,000 from pot
*** SUMMARY ***
Total pot 87,000 | Rake 0 | Jackpot 0 | Bingo 0 | Fortune 0 | Tax 0
Seat 1: b81c9328 (small blind) collected (87,000)
Seat 2: 9feeaa16 (big blind) folded before Flop
Seat 3: dd346f3c folded before Flop
Seat 4: 182dd106 folded before Flop
Seat 5: b11600f1 folded before Flop
Seat 6: Hero (button) folded before Flop


Poker Hand #TM4180648034: Tournament #187165250, Mini Hypersonic $2.50 Hold'em No Limit - Level34(15,000/30,000) - 2025/02/03 18:17:22
Table '40' 6-max Seat #5 is the button
Seat 1: b81c9328 (433,444 in chips)
Seat 2: 9feeaa16 (295,321 in chips)
Seat 3: dd346f3c (542,596 in chips)
Seat 4: 182dd106 (511,112 in chips)
Seat 5: b11600f1 (424,480 in chips)
Seat 6: Hero (641,200 in chips)
Hero: posts the ante 4,500
b81c9328: posts the ante 4,500
182dd106: posts the ante 4,500
9feeaa16: posts the ante 4,500
b11600f1: posts the ante 4,500
dd346f3c: posts the ante 4,500
Hero: posts small blind 15,000
b81c9328: posts big blind 30,000
*** HOLE CARDS ***
Dealt to b81c9328 
Dealt to 9feeaa16 
Dealt to dd346f3c 
Dealt to 182dd106 
Dealt to b11600f1 
Dealt to Hero [Kc Td]
9feeaa16: raises 260,821 to 290,821 and is all-in
dd346f3c: folds
182dd106: folds
b11600f1: folds
Hero: folds
b81c9328: folds
Uncalled bet (260,821) returned to 9feeaa16
*** SHOWDOWN ***
9feeaa16 collected 102,000 from pot
*** SUMMARY ***
Total pot 102,000 | Rake 0 | Jackpot 0 | Bingo 0 | Fortune 0 | Tax 0
Seat 1: b81c9328 (big blind) folded before Flop
Seat 2: 9feeaa16 collected (102,000)
Seat 3: dd346f3c folded before Flop
Seat 4: 182dd106 folded before Flop
Seat 5: b11600f1 (button) folded before Flop
Seat 6: Hero (small blind) folded before Flop


Poker Hand #TM4180648015: Tournament #187165250, Mini Hypersonic $2.50 Hold'em No Limit - Level34(15,000/30,000) - 2025/02/03 18:17:01
Table '40' 6-max Seat #4 is the button
Seat 1: b81c9328 (365,944 in chips)
Seat 2: 9feeaa16 (299,821 in chips)
Seat 3: dd346f3c (547,096 in chips)
Seat 4: 182dd106 (515,612 in chips)
Seat 5: b11600f1 (443,980 in chips)
Seat 6: Hero (675,700 in chips)
Hero: posts the ante 4,500
b81c9328: posts the ante 4,500
182dd106: posts the ante 4,500
9feeaa16: posts the ante 4,500
dd346f3c: posts the ante 4,500
b11600f1: posts the ante 4,500
b11600f1: posts small blind 15,000
Hero: posts big blind 30,000
*** HOLE CARDS ***
Dealt to b81c9328 
Dealt to 9feeaa16 
Dealt to dd346f3c 
Dealt to 182dd106 
Dealt to b11600f1 
Dealt to Hero [Ac 7h]
b81c9328: raises 331,444 to 361,444 and is all-in
9feeaa16: folds
dd346f3c: folds
182dd106: folds
b11600f1: folds
Hero: folds
Uncalled bet (331,444) returned to b81c9328
*** SHOWDOWN ***
b81c9328 collected 102,000 from pot
*** SUMMARY ***
Total pot 102,000 | Rake 0 | Jackpot 0 | Bingo 0 | Fortune 0 | Tax 0
Seat 1: b81c9328 collected (102,000)
Seat 2: 9feeaa16 folded before Flop
Seat 3: dd346f3c folded before Flop
Seat 4: 182dd106 (button) folded before Flop
Seat 5: b11600f1 (small blind) folded before Flop
Seat 6: Hero (big blind) folded before Flop


Poker Hand #TM4180648008: Tournament #187165250, Mini Hypersonic $2.50 Hold'em No Limit - Level34(15,000/30,000) - 2025/02/03 18:16:49
Table '40' 6-max Seat #3 is the button
Seat 3: dd346f3c (551,596 in chips)
Seat 4: 182dd106 (535,112 in chips)
Seat 5: b11600f1 (415,480 in chips)
Seat 6: Hero (680,200 in chips)
Hero: posts the ante 4,500
182dd106: posts the ante 4,500
dd346f3c: posts the ante 4,500
b11600f1: posts the ante 4,500
182dd106: posts small blind 15,000
b11600f1: posts big blind 30,000
*** HOLE CARDS ***
Dealt to dd346f3c 
Dealt to 182dd106 
Dealt to b11600f1 
Dealt to Hero [3h 4h]
Hero: folds
dd346f3c: folds
182dd106: folds
Uncalled bet (15,000) returned to b11600f1
*** SHOWDOWN ***
b11600f1 collected 48,000 from pot
*** SUMMARY ***
Total pot 48,000 | Rake 0 | Jackpot 0 | Bingo 0 | Fortune 0 | Tax 0
Seat 3: dd346f3c (button) folded before Flop
Seat 4: 182dd106 (small blind) folded before Flop
Seat 5: b11600f1 (big blind) showed [Ad Ah] and collected (48,000)
Seat 6: Hero folded before Flop


Poker Hand #TM4180648000: Tournament #187165250, Mini Hypersonic $2.50 Hold'em No Limit - Level34(15,000/30,000) - 2025/02/03 18:16:37
Table '40' 6-max Seat #6 is the button
Seat 3: dd346f3c (571,096 in chips)
Seat 4: 182dd106 (506,612 in chips)
Seat 5: b11600f1 (419,980 in chips)
Seat 6: Hero (684,700 in chips)
Hero: posts the ante 4,500
182dd106: posts the ante 4,500
b11600f1: posts the ante 4,500
dd346f3c: posts the ante 4,500
dd346f3c: posts small blind 15,000
182dd106: posts big blind 30,000
*** HOLE CARDS ***
Dealt to dd346f3c 
Dealt to 182dd106 
Dealt to b11600f1 
Dealt to Hero [9h Tc]
b11600f1: folds
Hero: folds
dd346f3c: folds
Uncalled bet (15,000) returned to 182dd106
*** SHOWDOWN ***
182dd106 collected 48,000 from pot
*** SUMMARY ***
Total pot 48,000 | Rake 0 | Jackpot 0 | Bingo 0 | Fortune 0 | Tax 0
Seat 3: dd346f3c (small blind) folded before Flop
Seat 4: 182dd106 (big blind) collected (48,000)
Seat 5: b11600f1 folded before Flop
Seat 6: Hero (button) folded before Flop


Poker Hand #TM4180647975: Tournament #187165250, Mini Hypersonic $2.50 Hold'em No Limit - Level34(15,000/30,000) - 2025/02/03 18:15:58
Table '40' 6-max Seat #5 is the button
Seat 2: a32338e3 (202,332 in chips)
Seat 3: dd346f3c (575,596 in chips)
Seat 4: 182dd106 (511,112 in chips)
Seat 5: b11600f1 (424,480 in chips)
Seat 6: Hero (468,868 in chips)
Hero: posts the ante 4,500
a32338e3: posts the ante 4,500
182dd106: posts the ante 4,500
b11600f1: posts the ante 4,500
dd346f3c: posts the ante 4,500
Hero: posts small blind 15,000
a32338e3: posts big blind 30,000
*** HOLE CARDS ***
Dealt to a32338e3 
Dealt to dd346f3c 
Dealt to 182dd106 
Dealt to b11600f1 
Dealt to Hero [5c 6d]
dd346f3c: folds
182dd106: folds
b11600f1: folds
Hero: raises 210,000 to 240,000
a32338e3: calls 167,832 and is all-in
Uncalled bet (42,168) returned to Hero
Hero: shows [5c 6d]
a32338e3: shows [Kd Ac]
*** FLOP *** [4d 3c 5h]
*** TURN *** [4d 3c 5h] [6s]
*** RIVER *** [4d 3c 5h 6s] [Kc]
*** SHOWDOWN ***
Hero collected 418,164 from pot
*** SUMMARY ***
Total pot 418,164 | Rake 0 | Jackpot 0 | Bingo 0 | Fortune 0 | Tax 0
Board [4d 3c 5h 6s Kc]
Seat 2: a32338e3 (big blind) showed [Kd Ac] and lost with Pair of Kings
Seat 3: dd346f3c folded before Flop
Seat 4: 182dd106 folded before Flop
Seat 5: b11600f1 (button) folded before Flop
Seat 6: Hero (small blind) showed [5c 6d] and won (418,164) with Pair of Sixes and Pair of Fives


Poker Hand #TM4180647966: Tournament #187165250, Mini Hypersonic $2.50 Hold'em No Limit - Level34(15,000/30,000) - 2025/02/03 18:15:42
Table '40' 6-max Seat #4 is the button
Seat 2: a32338e3 (206,832 in chips)
Seat 3: dd346f3c (580,096 in chips)
Seat 4: 182dd106 (515,612 in chips)
Seat 5: b11600f1 (443,980 in chips)
Seat 6: Hero (435,868 in chips)
Hero: posts the ante 4,500
a32338e3: posts the ante 4,500
182dd106: posts the ante 4,500
dd346f3c: posts the ante 4,500
b11600f1: posts the ante 4,500
b11600f1: posts small blind 15,000
Hero: posts big blind 30,000
*** HOLE CARDS ***
Dealt to a32338e3 
Dealt to dd346f3c 
Dealt to 182dd106 
Dealt to b11600f1 
Dealt to Hero [3c 8c]
a32338e3: folds
dd346f3c: folds
182dd106: folds
b11600f1: folds
Uncalled bet (15,000) returned to Hero
*** SHOWDOWN ***
Hero collected 52,500 from pot
*** SUMMARY ***
Total pot 52,500 | Rake 0 | Jackpot 0 | Bingo 0 | Fortune 0 | Tax 0
Seat 2: a32338e3 folded before Flop
Seat 3: dd346f3c folded before Flop
Seat 4: 182dd106 (button) folded before Flop
Seat 5: b11600f1 (small blind) folded before Flop
Seat 6: Hero (big blind) collected (52,500)


Poker Hand #TM4180647948: Tournament #187165250, Mini Hypersonic $2.50 Hold'em No Limit - Level34(15,000/30,000) - 2025/02/03 18:15:19
Table '40' 6-max Seat #3 is the button
Seat 2: a32338e3 (211,332 in chips)
Seat 3: dd346f3c (644,596 in chips)
Seat 4: 182dd106 (407,612 in chips)
Seat 5: b11600f1 (478,480 in chips)
Seat 6: Hero (440,368 in chips)
Hero: posts the ante 4,500
a32338e3: posts the ante 4,500
182dd106: posts the ante 4,500
dd346f3c: posts the ante 4,500
b11600f1: posts the ante 4,500
182dd106: posts small blind 15,000
b11600f1: posts big blind 30,000
*** HOLE CARDS ***
Dealt to a32338e3 
Dealt to dd346f3c 
Dealt to 182dd106 
Dealt to b11600f1 
Dealt to Hero [2s 4d]
Hero: folds
a32338e3: folds
dd346f3c: raises 30,000 to 60,000
182dd106: raises 343,112 to 403,112 and is all-in
b11600f1: folds
dd346f3c: folds
Uncalled bet (343,112) returned to 182dd106
*** SHOWDOWN ***
182dd106 collected 172,500 from pot
*** SUMMARY ***
Total pot 172,500 | Rake 0 | Jackpot 0 | Bingo 0 | Fortune 0 | Tax 0
Seat 2: a32338e3 folded before Flop
Seat 3: dd346f3c (button) folded before Flop
Seat 4: 182dd106 (small blind) collected (172,500)
Seat 5: b11600f1 (big blind) folded before Flop
Seat 6: Hero folded before Flop


Poker Hand #TM4180647931: Tournament #187165250, Mini Hypersonic $2.50 Hold'em No Limit - Level34(15,000/30,000) - 2025/02/03 18:15:03
Table '40' 6-max Seat #2 is the button
Seat 2: a32338e3 (215,832 in chips)
Seat 3: dd346f3c (664,096 in chips)
Seat 4: 182dd106 (374,612 in chips)
Seat 5: b11600f1 (482,980 in chips)
Seat 6: Hero (444,868 in chips)
Hero: posts the ante 4,500
a32338e3: posts the ante 4,500
182dd106: posts the ante 4,500
b11600f1: posts the ante 4,500
dd346f3c: posts the ante 4,500
dd346f3c: posts small blind 15,000
182dd106: posts big blind 30,000
*** HOLE CARDS ***
Dealt to a32338e3 
Dealt to dd346f3c 
Dealt to 182dd106 
Dealt to b11600f1 
Dealt to Hero [3d Jh]
b11600f1: folds
Hero: folds
a32338e3: folds
dd346f3c: folds
Uncalled bet (15,000) returned to 182dd106
*** SHOWDOWN ***
182dd106 collected 52,500 from pot
*** SUMMARY ***
Total pot 52,500 | Rake 0 | Jackpot 0 | Bingo 0 | Fortune 0 | Tax 0
Seat 2: a32338e3 (button) folded before Flop
Seat 3: dd346f3c (small blind) folded before Flop
Seat 4: 182dd106 (big blind) collected (52,500)
Seat 5: b11600f1 folded before Flop
Seat 6: Hero folded before Flop


Poker Hand #TM4180647900: Tournament #187165250, Mini Hypersonic $2.50 Hold'em No Limit - Level33(12,500/25,000) - 2025/02/03 18:14:28
Table '40' 6-max Seat #6 is the button
Seat 1: 29cb19d7 (79,829 in chips)
Seat 2: a32338e3 (244,332 in chips)
Seat 3: dd346f3c (667,596 in chips)
Seat 4: 182dd106 (378,112 in chips)
Seat 5: b11600f1 (486,480 in chips)
Seat 6: Hero (326,039 in chips)
29cb19d7: posts the ante 3,500
Hero: posts the ante 3,500
a32338e3: posts the ante 3,500
182dd106: posts the ante 3,500
b11600f1: posts the ante 3,500
dd346f3c: posts the ante 3,500
29cb19d7: posts small blind 12,500
a32338e3: posts big blind 25,000
*** HOLE CARDS ***
Dealt to 29cb19d7 
Dealt to a32338e3 
Dealt to dd346f3c 
Dealt to 182dd106 
Dealt to b11600f1 
Dealt to Hero [As 7c]
dd346f3c: folds
182dd106: folds
b11600f1: folds
Hero: raises 297,539 to 322,539 and is all-in
29cb19d7: calls 63,829 and is all-in
a32338e3: folds
Uncalled bet (246,210) returned to Hero
Hero: shows [As 7c]
29cb19d7: shows [Kc Td]
*** FLOP *** [7h 6h 4c]
*** TURN *** [7h 6h 4c] [2d]
*** RIVER *** [7h 6h 4c 2d] [5s]
*** SHOWDOWN ***
Hero collected 198,658 from pot
*** SUMMARY ***
Total pot 198,658 | Rake 0 | Jackpot 0 | Bingo 0 | Fortune 0 | Tax 0
Board [7h 6h 4c 2d 5s]
Seat 1: 29cb19d7 (small blind) showed [Kc Td] and lost with King-High
Seat 2: a32338e3 (big blind) folded before Flop
Seat 3: dd346f3c folded before Flop
Seat 4: 182dd106 folded before Flop
Seat 5: b11600f1 folded before Flop
Seat 6: Hero (button) showed [As 7c] and won (198,658) with Pair of Sevens


Poker Hand #TM4180647874: Tournament #187165250, Mini Hypersonic $2.50 Hold'em No Limit - Level33(12,500/25,000) - 2025/02/03 18:13:44
Table '40' 6-max Seat #5 is the button
Seat 1: 29cb19d7 (309,819 in chips)
Seat 2: a32338e3 (247,832 in chips)
Seat 3: dd346f3c (671,096 in chips)
Seat 4: 182dd106 (381,612 in chips)
Seat 5: b11600f1 (229,990 in chips)
Seat 6: Hero (342,039 in chips)
29cb19d7: posts the ante 3,500
Hero: posts the ante 3,500
a32338e3: posts the ante 3,500
182dd106: posts the ante 3,500
b11600f1: posts the ante 3,500
dd346f3c: posts the ante 3,500
Hero: posts small blind 12,500
29cb19d7: posts big blind 25,000
*** HOLE CARDS ***
Dealt to 29cb19d7 
Dealt to a32338e3 
Dealt to dd346f3c 
Dealt to 182dd106 
Dealt to b11600f1 
Dealt to Hero [8s 3s]
a32338e3: folds
dd346f3c: folds
182dd106: folds
b11600f1: raises 201,490 to 226,490 and is all-in
Hero: folds
29cb19d7: calls 201,490
b11600f1: shows [8h 8d]
29cb19d7: shows [As Tc]
*** FLOP *** [Kc Ks 7h]
*** TURN *** [Kc Ks 7h] [3h]
*** RIVER *** [Kc Ks 7h 3h] [5h]
*** SHOWDOWN ***
b11600f1 collected 486,480 from pot
*** SUMMARY ***
Total pot 486,480 | Rake 0 | Jackpot 0 | Bingo 0 | Fortune 0 | Tax 0
Board [Kc Ks 7h 3h 5h]
Seat 1: 29cb19d7 (big blind) showed [As Tc] and lost with Pair of Kings
Seat 2: a32338e3 folded before Flop
Seat 3: dd346f3c folded before Flop
Seat 4: 182dd106 folded before Flop
Seat 5: b11600f1 (button) showed [8h 8d] and won (486,480) with Pair of Kings and Pair of Eights
Seat 6: Hero (small blind) folded before Flop


Poker Hand #TM4180647861: Tournament #187165250, Mini Hypersonic $2.50 Hold'em No Limit - Level33(12,500/25,000) - 2025/02/03 18:13:31
Table '40' 6-max Seat #4 is the button
Seat 1: 29cb19d7 (313,319 in chips)
Seat 2: a32338e3 (251,332 in chips)
Seat 3: dd346f3c (674,596 in chips)
Seat 4: 182dd106 (385,112 in chips)
Seat 5: b11600f1 (245,990 in chips)
Seat 6: Hero (312,039 in chips)
29cb19d7: posts the ante 3,500
Hero: posts the ante 3,500
a32338e3: posts the ante 3,500
182dd106: posts the ante 3,500
dd346f3c: posts the ante 3,500
b11600f1: posts the ante 3,500
b11600f1: posts small blind 12,500
Hero: posts big blind 25,000
*** HOLE CARDS ***
Dealt to 29cb19d7 
Dealt to a32338e3 
Dealt to dd346f3c 
Dealt to 182dd106 
Dealt to b11600f1 
Dealt to Hero [3c Ts]
29cb19d7: folds
a32338e3: folds
dd346f3c: folds
182dd106: folds
b11600f1: folds
Uncalled bet (12,500) returned to Hero
*** SHOWDOWN ***
Hero collected 46,000 from pot
*** SUMMARY ***
Total pot 46,000 | Rake 0 | Jackpot 0 | Bingo 0 | Fortune 0 | Tax 0
Seat 1: 29cb19d7 folded before Flop
Seat 2: a32338e3 folded before Flop
Seat 3: dd346f3c folded before Flop
Seat 4: 182dd106 (button) folded before Flop
Seat 5: b11600f1 (small blind) folded before Flop
Seat 6: Hero (big blind) collected (46,000)


Poker Hand #TM4180647843: Tournament #187165250, Mini Hypersonic $2.50 Hold'em No Limit - Level33(12,500/25,000) - 2025/02/03 18:13:05
Table '40' 6-max Seat #3 is the button
Seat 1: 29cb19d7 (316,819 in chips)
Seat 2: a32338e3 (254,832 in chips)
Seat 3: dd346f3c (678,096 in chips)
Seat 4: 182dd106 (342,612 in chips)
Seat 5: b11600f1 (274,490 in chips)
Seat 6: Hero (315,539 in chips)
29cb19d7: posts the ante 3,500
Hero: posts the ante 3,500
a32338e3: posts the ante 3,500
182dd106: posts the ante 3,500
dd346f3c: posts the ante 3,500
b11600f1: posts the ante 3,500
182dd106: posts small blind 12,500
b11600f1: posts big blind 25,000
*** HOLE CARDS ***
Dealt to 29cb19d7 
Dealt to a32338e3 
Dealt to dd346f3c 
Dealt to 182dd106 
Dealt to b11600f1 
Dealt to Hero [Ad 3s]
Hero: folds
29cb19d7: folds
a32338e3: folds
dd346f3c: folds
182dd106: raises 37,500 to 62,500
b11600f1: folds
Uncalled bet (37,500) returned to 182dd106
*** SHOWDOWN ***
182dd106 collected 71,000 from pot
*** SUMMARY ***
Total pot 71,000 | Rake 0 | Jackpot 0 | Bingo 0 | Fortune 0 | Tax 0
Seat 1: 29cb19d7 folded before Flop
Seat 2: a32338e3 folded before Flop
Seat 3: dd346f3c (button) folded before Flop
Seat 4: 182dd106 (small blind) collected (71,000)
Seat 5: b11600f1 (big blind) folded before Flop
Seat 6: Hero folded before Flop


Poker Hand #TM4180647828: Tournament #187165250, Mini Hypersonic $2.50 Hold'em No Limit - Level33(12,500/25,000) - 2025/02/03 18:12:45
Table '40' 6-max Seat #2 is the button
Seat 1: 29cb19d7 (320,319 in chips)
Seat 2: a32338e3 (258,332 in chips)
Seat 3: dd346f3c (694,096 in chips)
Seat 4: 182dd106 (371,112 in chips)
Seat 5: b11600f1 (219,490 in chips)
Seat 6: Hero (319,039 in chips)
29cb19d7: posts the ante 3,500
Hero: posts the ante 3,500
a32338e3: posts the ante 3,500
182dd106: posts the ante 3,500
b11600f1: posts the ante 3,500
dd346f3c: posts the ante 3,500
dd346f3c: posts small blind 12,500
182dd106: posts big blind 25,000
*** HOLE CARDS ***
Dealt to 29cb19d7 
Dealt to a32338e3 
Dealt to dd346f3c 
Dealt to 182dd106 
Dealt to b11600f1 
Dealt to Hero [8h 7h]
b11600f1: raises 190,990 to 215,990 and is all-in
Hero: folds
29cb19d7: folds
a32338e3: folds
dd346f3c: folds
182dd106: folds
Uncalled bet (190,990) returned to b11600f1
*** SHOWDOWN ***
b11600f1 collected 83,500 from pot
*** SUMMARY ***
Total pot 83,500 | Rake 0 | Jackpot 0 | Bingo 0 | Fortune 0 | Tax 0
Seat 1: 29cb19d7 folded before Flop
Seat 2: a32338e3 (button) folded before Flop
Seat 3: dd346f3c (small blind) folded before Flop
Seat 4: 182dd106 (big blind) folded before Flop
Seat 5: b11600f1 showed [Ac] and collected (83,500)
Seat 6: Hero folded before Flop


Poker Hand #TM4180647806: Tournament #187165250, Mini Hypersonic $2.50 Hold'em No Limit - Level33(12,500/25,000) - 2025/02/03 18:12:23
Table '40' 6-max Seat #1 is the button
Seat 1: 29cb19d7 (323,819 in chips)
Seat 2: a32338e3 (274,332 in chips)
Seat 3: dd346f3c (722,596 in chips)
Seat 4: 182dd106 (374,612 in chips)
Seat 5: b11600f1 (222,990 in chips)
Seat 6: Hero (264,039 in chips)
29cb19d7: posts the ante 3,500
Hero: posts the ante 3,500
a32338e3: posts the ante 3,500
182dd106: posts the ante 3,500
b11600f1: posts the ante 3,500
dd346f3c: posts the ante 3,500
a32338e3: posts small blind 12,500
dd346f3c: posts big blind 25,000
*** HOLE CARDS ***
Dealt to 29cb19d7 
Dealt to a32338e3 
Dealt to dd346f3c 
Dealt to 182dd106 
Dealt to b11600f1 
Dealt to Hero [7s 7d]
182dd106: folds
b11600f1: folds
Hero: raises 235,539 to 260,539 and is all-in
29cb19d7: folds
a32338e3: folds
dd346f3c: folds
Uncalled bet (235,539) returned to Hero
*** SHOWDOWN ***
Hero collected 83,500 from pot
*** SUMMARY ***
Total pot 83,500 | Rake 0 | Jackpot 0 | Bingo 0 | Fortune 0 | Tax 0
Seat 1: 29cb19d7 (button) folded before Flop
Seat 2: a32338e3 (small blind) folded before Flop
Seat 3: dd346f3c (big blind) folded before Flop
Seat 4: 182dd106 folded before Flop
Seat 5: b11600f1 folded before Flop
Seat 6: Hero collected (83,500)


Poker Hand #TM4180647797: Tournament #187165250, Mini Hypersonic $2.50 Hold'em No Limit - Level33(12,500/25,000) - 2025/02/03 18:12:04
Table '40' 6-max Seat #6 is the button
Seat 1: 29cb19d7 (339,819 in chips)
Seat 2: a32338e3 (302,832 in chips)
Seat 3: dd346f3c (667,596 in chips)
Seat 4: 182dd106 (378,112 in chips)
Seat 5: b11600f1 (226,490 in chips)
Seat 6: Hero (267,539 in chips)
29cb19d7: posts the ante 3,500
Hero: posts the ante 3,500
a32338e3: posts the ante 3,500
182dd106: posts the ante 3,500
b11600f1: posts the ante 3,500
dd346f3c: posts the ante 3,500
29cb19d7: posts small blind 12,500
a32338e3: posts big blind 25,000
*** HOLE CARDS ***
Dealt to 29cb19d7 
Dealt to a32338e3 
Dealt to dd346f3c 
Dealt to 182dd106 
Dealt to b11600f1 
Dealt to Hero [6h Ks]
dd346f3c: raises 25,000 to 50,000
182dd106: folds
b11600f1: folds
Hero: folds
29cb19d7: folds
a32338e3: folds
Uncalled bet (25,000) returned to dd346f3c
*** SHOWDOWN ***
dd346f3c collected 83,500 from pot
*** SUMMARY ***
Total pot 83,500 | Rake 0 | Jackpot 0 | Bingo 0 | Fortune 0 | Tax 0
Seat 1: 29cb19d7 (small blind) folded before Flop
Seat 2: a32338e3 (big blind) folded before Flop
Seat 3: dd346f3c collected (83,500)
Seat 4: 182dd106 folded before Flop
Seat 5: b11600f1 folded before Flop
Seat 6: Hero (button) folded before Flop


Poker Hand #TM4180647785: Tournament #187165250, Mini Hypersonic $2.50 Hold'em No Limit - Level33(12,500/25,000) - 2025/02/03 18:11:49
Table '40' 6-max Seat #4 is the button
Seat 1: 29cb19d7 (313,319 in chips)
Seat 2: a32338e3 (306,332 in chips)
Seat 3: dd346f3c (671,096 in chips)
Seat 4: 182dd106 (381,612 in chips)
Seat 6: Hero (283,539 in chips)
29cb19d7: posts the ante 3,500
Hero: posts the ante 3,500
a32338e3: posts the ante 3,500
182dd106: posts the ante 3,500
dd346f3c: posts the ante 3,500
Hero: posts small blind 12,500
29cb19d7: posts big blind 25,000
*** HOLE CARDS ***
Dealt to 29cb19d7 
Dealt to a32338e3 
Dealt to dd346f3c 
Dealt to 182dd106 
Dealt to Hero [8d 4c]
a32338e3: folds
dd346f3c: folds
182dd106: folds
Hero: folds
Uncalled bet (12,500) returned to 29cb19d7
*** SHOWDOWN ***
29cb19d7 collected 42,500 from pot
*** SUMMARY ***
Total pot 42,500 | Rake 0 | Jackpot 0 | Bingo 0 | Fortune 0 | Tax 0
Seat 1: 29cb19d7 (big blind) collected (42,500)
Seat 2: a32338e3 folded before Flop
Seat 3: dd346f3c folded before Flop
Seat 4: 182dd106 (button) folded before Flop
Seat 6: Hero (small blind) folded before Flop


Poker Hand #TM4180647774: Tournament #187165250, Mini Hypersonic $2.50 Hold'em No Limit - Level33(12,500/25,000) - 2025/02/03 18:11:33
Table '40' 6-max Seat #3 is the button
Seat 1: 29cb19d7 (316,819 in chips)
Seat 2: a32338e3 (309,832 in chips)
Seat 3: dd346f3c (674,596 in chips)
Seat 4: 182dd106 (342,612 in chips)
Seat 6: Hero (312,039 in chips)
29cb19d7: posts the ante 3,500
Hero: posts the ante 3,500
a32338e3: posts the ante 3,500
182dd106: posts the ante 3,500
dd346f3c: posts the ante 3,500
182dd106: posts small blind 12,500
Hero: posts big blind 25,000
*** HOLE CARDS ***
Dealt to 29cb19d7 
Dealt to a32338e3 
Dealt to dd346f3c 
Dealt to 182dd106 
Dealt to Hero [Jd 7h]
29cb19d7: folds
a32338e3: folds
dd346f3c: folds
182dd106: raises 314,112 to 339,112 and is all-in
Hero: folds
Uncalled bet (314,112) returned to 182dd106
*** SHOWDOWN ***
182dd106 collected 67,500 from pot
*** SUMMARY ***
Total pot 67,500 | Rake 0 | Jackpot 0 | Bingo 0 | Fortune 0 | Tax 0
Seat 1: 29cb19d7 folded before Flop
Seat 2: a32338e3 folded before Flop
Seat 3: dd346f3c (button) folded before Flop
Seat 4: 182dd106 (small blind) collected (67,500)
Seat 6: Hero (big blind) folded before Flop


Poker Hand #TM4180647756: Tournament #187165250, Mini Hypersonic $2.50 Hold'em No Limit - Level33(12,500/25,000) - 2025/02/03 18:11:15
Table '40' 6-max Seat #2 is the button
Seat 1: 29cb19d7 (320,319 in chips)
Seat 2: a32338e3 (258,332 in chips)
Seat 3: dd346f3c (690,596 in chips)
Seat 4: 182dd106 (371,112 in chips)
Seat 6: Hero (315,539 in chips)
29cb19d7: posts the ante 3,500
Hero: posts the ante 3,500
a32338e3: posts the ante 3,500
182dd106: posts the ante 3,500
dd346f3c: posts the ante 3,500
dd346f3c: posts small blind 12,500
182dd106: posts big blind 25,000
*** HOLE CARDS ***
Dealt to 29cb19d7 
Dealt to a32338e3 
Dealt to dd346f3c 
Dealt to 182dd106 
Dealt to Hero [9s Jd]
Hero: folds
29cb19d7: folds
a32338e3: raises 229,832 to 254,832 and is all-in
dd346f3c: folds
182dd106: folds
Uncalled bet (229,832) returned to a32338e3
*** SHOWDOWN ***
a32338e3 collected 80,000 from pot
*** SUMMARY ***
Total pot 80,000 | Rake 0 | Jackpot 0 | Bingo 0 | Fortune 0 | Tax 0
Seat 1: 29cb19d7 folded before Flop
Seat 2: a32338e3 (button) collected (80,000)
Seat 3: dd346f3c (small blind) folded before Flop
Seat 4: 182dd106 (big blind) folded before Flop
Seat 6: Hero folded before Flop


Poker Hand #TM4180647738: Tournament #187165250, Mini Hypersonic $2.50 Hold'em No Limit - Level32(10,000/20,000) - 2025/02/03 18:10:44
Table '40' 6-max Seat #1 is the button
Seat 1: 29cb19d7 (323,319 in chips)
Seat 2: a32338e3 (271,332 in chips)
Seat 3: dd346f3c (437,702 in chips)
Seat 4: 182dd106 (374,112 in chips)
Seat 5: c9563272 (230,894 in chips)
Seat 6: Hero (318,539 in chips)
29cb19d7: posts the ante 3,000
Hero: posts the ante 3,000
a32338e3: posts the ante 3,000
c9563272: posts the ante 3,000
182dd106: posts the ante 3,000
dd346f3c: posts the ante 3,000
a32338e3: posts small blind 10,000
dd346f3c: posts big blind 20,000
*** HOLE CARDS ***
Dealt to 29cb19d7 
Dealt to a32338e3 
Dealt to dd346f3c 
Dealt to 182dd106 
Dealt to c9563272 
Dealt to Hero [7d 6s]
182dd106: folds
c9563272: raises 207,894 to 227,894 and is all-in
Hero: folds
29cb19d7: folds
a32338e3: folds
dd346f3c: calls 207,894
c9563272: shows [Jc Jh]
dd346f3c: shows [Ah Qs]
*** FLOP *** [3c 2h 2s]
*** TURN *** [3c 2h 2s] [Qd]
*** RIVER *** [3c 2h 2s Qd] [Kd]
*** SHOWDOWN ***
dd346f3c collected 483,788 from pot
*** SUMMARY ***
Total pot 483,788 | Rake 0 | Jackpot 0 | Bingo 0 | Fortune 0 | Tax 0
Board [3c 2h 2s Qd Kd]
Seat 1: 29cb19d7 (button) folded before Flop
Seat 2: a32338e3 (small blind) folded before Flop
Seat 3: dd346f3c (big blind) showed [Ah Qs] and won (483,788) with Pair of Queens and Pair of Twos
Seat 4: 182dd106 folded before Flop
Seat 5: c9563272 showed [Jc Jh] and lost with Pair of Jacks and Pair of Twos
Seat 6: Hero folded before Flop


Poker Hand #TM4180647719: Tournament #187165250, Mini Hypersonic $2.50 Hold'em No Limit - Level32(10,000/20,000) - 2025/02/03 18:10:18
Table '40' 6-max Seat #6 is the button
Seat 1: 29cb19d7 (288,319 in chips)
Seat 2: a32338e3 (294,332 in chips)
Seat 3: dd346f3c (440,702 in chips)
Seat 4: 182dd106 (377,112 in chips)
Seat 5: c9563272 (233,894 in chips)
Seat 6: Hero (321,539 in chips)
29cb19d7: posts the ante 3,000
Hero: posts the ante 3,000
a32338e3: posts the ante 3,000
c9563272: posts the ante 3,000
182dd106: posts the ante 3,000
dd346f3c: posts the ante 3,000
29cb19d7: posts small blind 10,000
a32338e3: posts big blind 20,000
*** HOLE CARDS ***
Dealt to 29cb19d7 
Dealt to a32338e3 
Dealt to dd346f3c 
Dealt to 182dd106 
Dealt to c9563272 
Dealt to Hero [9s 3d]
dd346f3c: folds
182dd106: folds
c9563272: folds
Hero: folds
29cb19d7: calls 10,000
a32338e3: checks
*** FLOP *** [7c 5d As]
29cb19d7: checks
a32338e3: checks
*** TURN *** [7c 5d As] [Ad]
29cb19d7: bets 29,000
a32338e3: folds
Uncalled bet (29,000) returned to 29cb19d7
*** SHOWDOWN ***
29cb19d7 collected 58,000 from pot
*** SUMMARY ***
Total pot 58,000 | Rake 0 | Jackpot 0 | Bingo 0 | Fortune 0 | Tax 0
Board [7c 5d As Ad]
Seat 1: 29cb19d7 (small blind) won (58,000)
Seat 2: a32338e3 (big blind) folded on the Turn
Seat 3: dd346f3c folded before Flop
Seat 4: 182dd106 folded before Flop
Seat 5: c9563272 folded before Flop
Seat 6: Hero (button) folded before Flop


Poker Hand #TM4180647692: Tournament #187165250, Mini Hypersonic $2.50 Hold'em No Limit - Level32(10,000/20,000) - 2025/02/03 18:09:37
Table '40' 6-max Seat #5 is the button
Seat 1: 29cb19d7 (331,319 in chips)
Seat 2: a32338e3 (229,332 in chips)
Seat 3: dd346f3c (443,702 in chips)
Seat 4: 182dd106 (380,112 in chips)
Seat 5: c9563272 (236,894 in chips)
Seat 6: Hero (334,539 in chips)
29cb19d7: posts the ante 3,000
Hero: posts the ante 3,000
a32338e3: posts the ante 3,000
c9563272: posts the ante 3,000
182dd106: posts the ante 3,000
dd346f3c: posts the ante 3,000
Hero: posts small blind 10,000
29cb19d7: posts big blind 20,000
*** HOLE CARDS ***
Dealt to 29cb19d7 
Dealt to a32338e3 
Dealt to dd346f3c 
Dealt to 182dd106 
Dealt to c9563272 
Dealt to Hero [Qd 6d]
a32338e3: raises 20,000 to 40,000
dd346f3c: folds
182dd106: folds
c9563272: folds
Hero: folds
29cb19d7: calls 20,000
*** FLOP *** [Ah 4c 2d]
29cb19d7: checks
a32338e3: bets 40,000
29cb19d7: folds
Uncalled bet (40,000) returned to a32338e3
*** SHOWDOWN ***
a32338e3 collected 108,000 from pot
*** SUMMARY ***
Total pot 108,000 | Rake 0 | Jackpot 0 | Bingo 0 | Fortune 0 | Tax 0
Board [Ah 4c 2d]
Seat 1: 29cb19d7 (big blind) folded on the Flop
Seat 2: a32338e3 won (108,000)
Seat 3: dd346f3c folded before Flop
Seat 4: 182dd106 folded before Flop
Seat 5: c9563272 (button) folded before Flop
Seat 6: Hero (small blind) folded before Flop


Poker Hand #TM4180647670: Tournament #187165250, Mini Hypersonic $2.50 Hold'em No Limit - Level32(10,000/20,000) - 2025/02/03 18:09:06
Table '40' 6-max Seat #4 is the button
Seat 1: 29cb19d7 (334,319 in chips)
Seat 2: a32338e3 (232,332 in chips)
Seat 3: dd346f3c (446,702 in chips)
Seat 4: 182dd106 (315,112 in chips)
Seat 5: c9563272 (249,894 in chips)
Seat 6: Hero (377,539 in chips)
29cb19d7: posts the ante 3,000
Hero: posts the ante 3,000
a32338e3: posts the ante 3,000
182dd106: posts the ante 3,000
c9563272: posts the ante 3,000
dd346f3c: posts the ante 3,000
c9563272: posts small blind 10,000
Hero: posts big blind 20,000
*** HOLE CARDS ***
Dealt to 29cb19d7 
Dealt to a32338e3 
Dealt to dd346f3c 
Dealt to 182dd106 
Dealt to c9563272 
Dealt to Hero [7h 8h]
29cb19d7: folds
a32338e3: folds
dd346f3c: folds
182dd106: raises 20,000 to 40,000
c9563272: folds
Hero: calls 20,000
*** FLOP *** [Ks Qd 9s]
Hero: checks
182dd106: bets 40,000
Hero: folds
Uncalled bet (40,000) returned to 182dd106
*** SHOWDOWN ***
182dd106 collected 108,000 from pot
*** SUMMARY ***
Total pot 108,000 | Rake 0 | Jackpot 0 | Bingo 0 | Fortune 0 | Tax 0
Board [Ks Qd 9s]
Seat 1: 29cb19d7 folded before Flop
Seat 2: a32338e3 folded before Flop
Seat 3: dd346f3c folded before Flop
Seat 4: 182dd106 (button) won (108,000)
Seat 5: c9563272 (small blind) folded before Flop
Seat 6: Hero (big blind) folded on the Flop


Poker Hand #TM4180647642: Tournament #187165250, Mini Hypersonic $2.50 Hold'em No Limit - Level32(10,000/20,000) - 2025/02/03 18:08:33
Table '40' 6-max Seat #3 is the button
Seat 1: 29cb19d7 (337,319 in chips)
Seat 2: a32338e3 (235,332 in chips)
Seat 3: dd346f3c (449,702 in chips)
Seat 4: 182dd106 (338,112 in chips)
Seat 5: c9563272 (214,894 in chips)
Seat 6: Hero (380,539 in chips)
29cb19d7: posts the ante 3,000
Hero: posts the ante 3,000
a32338e3: posts the ante 3,000
c9563272: posts the ante 3,000
182dd106: posts the ante 3,000
dd346f3c: posts the ante 3,000
182dd106: posts small blind 10,000
c9563272: posts big blind 20,000
*** HOLE CARDS ***
Dealt to 29cb19d7 
Dealt to a32338e3 
Dealt to dd346f3c 
Dealt to 182dd106 
Dealt to c9563272 
Dealt to Hero [4h 3h]
Hero: folds
29cb19d7: folds
a32338e3: folds
dd346f3c: folds
182dd106: calls 10,000
c9563272: raises 191,894 to 211,894 and is all-in
182dd106: folds
Uncalled bet (191,894) returned to c9563272
*** SHOWDOWN ***
c9563272 collected 58,000 from pot
*** SUMMARY ***
Total pot 58,000 | Rake 0 | Jackpot 0 | Bingo 0 | Fortune 0 | Tax 0
Seat 1: 29cb19d7 folded before Flop
Seat 2: a32338e3 folded before Flop
Seat 3: dd346f3c (button) folded before Flop
Seat 4: 182dd106 (small blind) folded before Flop
Seat 5: c9563272 (big blind) collected (58,000)
Seat 6: Hero folded before Flop


Poker Hand #TM4180647627: Tournament #187165250, Mini Hypersonic $2.50 Hold'em No Limit - Level32(10,000/20,000) - 2025/02/03 18:08:14
Table '40' 6-max Seat #2 is the button
Seat 1: 29cb19d7 (340,319 in chips)
Seat 2: a32338e3 (238,332 in chips)
Seat 3: dd346f3c (414,702 in chips)
Seat 4: 182dd106 (361,112 in chips)
Seat 5: c9563272 (217,894 in chips)
Seat 6: Hero (383,539 in chips)
29cb19d7: posts the ante 3,000
Hero: posts the ante 3,000
a32338e3: posts the ante 3,000
c9563272: posts the ante 3,000
182dd106: posts the ante 3,000
dd346f3c: posts the ante 3,000
dd346f3c: posts small blind 10,000
182dd106: posts big blind 20,000
*** HOLE CARDS ***
Dealt to 29cb19d7 
Dealt to a32338e3 
Dealt to dd346f3c 
Dealt to 182dd106 
Dealt to c9563272 
Dealt to Hero [Ks 8c]
c9563272: folds
Hero: folds
29cb19d7: folds
a32338e3: folds
dd346f3c: raises 20,000 to 40,000
182dd106: folds
Uncalled bet (20,000) returned to dd346f3c
*** SHOWDOWN ***
dd346f3c collected 58,000 from pot
*** SUMMARY ***
Total pot 58,000 | Rake 0 | Jackpot 0 | Bingo 0 | Fortune 0 | Tax 0
Seat 1: 29cb19d7 folded before Flop
Seat 2: a32338e3 (button) folded before Flop
Seat 3: dd346f3c (small blind) collected (58,000)
Seat 4: 182dd106 (big blind) folded before Flop
Seat 5: c9563272 folded before Flop
Seat 6: Hero folded before Flop


Poker Hand #TM4180647619: Tournament #187165250, Mini Hypersonic $2.50 Hold'em No Limit - Level32(10,000/20,000) - 2025/02/03 18:07:58
Table '40' 6-max Seat #1 is the button
Seat 1: 29cb19d7 (343,319 in chips)
Seat 2: a32338e3 (251,332 in chips)
Seat 3: dd346f3c (389,702 in chips)
Seat 4: 182dd106 (364,112 in chips)
Seat 5: c9563272 (220,894 in chips)
Seat 6: Hero (386,539 in chips)
29cb19d7: posts the ante 3,000
Hero: posts the ante 3,000
a32338e3: posts the ante 3,000
c9563272: posts the ante 3,000
182dd106: posts the ante 3,000
dd346f3c: posts the ante 3,000
a32338e3: posts small blind 10,000
dd346f3c: posts big blind 20,000
*** HOLE CARDS ***
Dealt to 29cb19d7 
Dealt to a32338e3 
Dealt to dd346f3c 
Dealt to 182dd106 
Dealt to c9563272 
Dealt to Hero [2h Ts]
182dd106: folds
c9563272: folds
Hero: folds
29cb19d7: folds
a32338e3: folds
Uncalled bet (10,000) returned to dd346f3c
*** SHOWDOWN ***
dd346f3c collected 38,000 from pot
*** SUMMARY ***
Total pot 38,000 | Rake 0 | Jackpot 0 | Bingo 0 | Fortune 0 | Tax 0
Seat 1: 29cb19d7 (button) folded before Flop
Seat 2: a32338e3 (small blind) folded before Flop
Seat 3: dd346f3c (big blind) collected (38,000)
Seat 4: 182dd106 folded before Flop
Seat 5: c9563272 folded before Flop
Seat 6: Hero folded before Flop


Poker Hand #TM4180647606: Tournament #187165250, Mini Hypersonic $2.50 Hold'em No Limit - Level32(10,000/20,000) - 2025/02/03 18:07:44
Table '40' 6-max Seat #6 is the button
Seat 1: 29cb19d7 (356,319 in chips)
Seat 2: a32338e3 (226,332 in chips)
Seat 3: dd346f3c (392,702 in chips)
Seat 4: 182dd106 (367,112 in chips)
Seat 5: c9563272 (223,894 in chips)
Seat 6: Hero (389,539 in chips)
29cb19d7: posts the ante 3,000
Hero: posts the ante 3,000
a32338e3: posts the ante 3,000
c9563272: posts the ante 3,000
182dd106: posts the ante 3,000
dd346f3c: posts the ante 3,000
29cb19d7: posts small blind 10,000
a32338e3: posts big blind 20,000
*** HOLE CARDS ***
Dealt to 29cb19d7 
Dealt to a32338e3 
Dealt to dd346f3c 
Dealt to 182dd106 
Dealt to c9563272 
Dealt to Hero [6h 8s]
dd346f3c: folds
182dd106: folds
c9563272: folds
Hero: folds
29cb19d7: folds
Uncalled bet (10,000) returned to a32338e3
*** SHOWDOWN ***
a32338e3 collected 38,000 from pot
*** SUMMARY ***
Total pot 38,000 | Rake 0 | Jackpot 0 | Bingo 0 | Fortune 0 | Tax 0
Seat 1: 29cb19d7 (small blind) folded before Flop
Seat 2: a32338e3 (big blind) collected (38,000)
Seat 3: dd346f3c folded before Flop
Seat 4: 182dd106 folded before Flop
Seat 5: c9563272 folded before Flop
Seat 6: Hero (button) folded before Flop


Poker Hand #TM4180647556: Tournament #187165250, Mini Hypersonic $2.50 Hold'em No Limit - Level31(8,000/16,000) - 2025/02/03 18:06:31
Table '40' 6-max Seat #5 is the button
Seat 1: 29cb19d7 (406,819 in chips)
Seat 2: a32338e3 (228,832 in chips)
Seat 3: dd346f3c (395,202 in chips)
Seat 4: 182dd106 (369,612 in chips)
Seat 5: c9563272 (226,394 in chips)
Seat 6: Hero (329,039 in chips)
29cb19d7: posts the ante 2,500
Hero: posts the ante 2,500
a32338e3: posts the ante 2,500
c9563272: posts the ante 2,500
182dd106: posts the ante 2,500
dd346f3c: posts the ante 2,500
Hero: posts small blind 8,000
29cb19d7: posts big blind 16,000
*** HOLE CARDS ***
Dealt to 29cb19d7 
Dealt to a32338e3 
Dealt to dd346f3c 
Dealt to 182dd106 
Dealt to c9563272 
Dealt to Hero [7c Jh]
a32338e3: folds
dd346f3c: folds
182dd106: folds
c9563272: folds
Hero: calls 8,000
29cb19d7: checks
*** FLOP *** [7d Jd 6d]
Hero: checks
29cb19d7: bets 32,000
Hero: calls 32,000
*** TURN *** [7d Jd 6d] [9d]
Hero: checks
29cb19d7: checks
*** RIVER *** [7d Jd 6d 9d] [2h]
Hero: bets 40,000
29cb19d7: folds
Uncalled bet (40,000) returned to Hero
*** SHOWDOWN ***
Hero collected 111,000 from pot
*** SUMMARY ***
Total pot 111,000 | Rake 0 | Jackpot 0 | Bingo 0 | Fortune 0 | Tax 0
Board [7d Jd 6d 9d 2h]
Seat 1: 29cb19d7 (big blind) folded on the River
Seat 2: a32338e3 folded before Flop
Seat 3: dd346f3c folded before Flop
Seat 4: 182dd106 folded before Flop
Seat 5: c9563272 (button) folded before Flop
Seat 6: Hero (small blind) won (111,000)


Poker Hand #TM4180647540: Tournament #187165250, Mini Hypersonic $2.50 Hold'em No Limit - Level31(8,000/16,000) - 2025/02/03 18:06:09
Table '40' 6-max Seat #4 is the button
Seat 1: 29cb19d7 (409,319 in chips)
Seat 2: a32338e3 (231,332 in chips)
Seat 3: dd346f3c (397,702 in chips)
Seat 4: 182dd106 (372,112 in chips)
Seat 5: c9563272 (244,894 in chips)
Seat 6: Hero (300,539 in chips)
29cb19d7: posts the ante 2,500
Hero: posts the ante 2,500
a32338e3: posts the ante 2,500
182dd106: posts the ante 2,500
c9563272: posts the ante 2,500
dd346f3c: posts the ante 2,500
c9563272: posts small blind 8,000
Hero: posts big blind 16,000
*** HOLE CARDS ***
Dealt to 29cb19d7 
Dealt to a32338e3 
Dealt to dd346f3c 
Dealt to 182dd106 
Dealt to c9563272 
Dealt to Hero [Qh 9s]
29cb19d7: folds
a32338e3: folds
dd346f3c: folds
182dd106: folds
c9563272: calls 8,000
Hero: raises 282,039 to 298,039 and is all-in
c9563272: folds
Uncalled bet (282,039) returned to Hero
*** SHOWDOWN ***
Hero collected 47,000 from pot
*** SUMMARY ***
Total pot 47,000 | Rake 0 | Jackpot 0 | Bingo 0 | Fortune 0 | Tax 0
Seat 1: 29cb19d7 folded before Flop
Seat 2: a32338e3 folded before Flop
Seat 3: dd346f3c folded before Flop
Seat 4: 182dd106 (button) folded before Flop
Seat 5: c9563272 (small blind) folded before Flop
Seat 6: Hero (big blind) collected (47,000)


Poker Hand #TM4180647531: Tournament #187165250, Mini Hypersonic $2.50 Hold'em No Limit - Level31(8,000/16,000) - 2025/02/03 18:05:58
Table '40' 6-max Seat #2 is the button
Seat 1: 29cb19d7 (411,819 in chips)
Seat 2: a32338e3 (233,832 in chips)
Seat 4: 182dd106 (382,612 in chips)
Seat 5: c9563272 (226,894 in chips)
Seat 6: Hero (303,039 in chips)
29cb19d7: posts the ante 2,500
Hero: posts the ante 2,500
a32338e3: posts the ante 2,500
c9563272: posts the ante 2,500
182dd106: posts the ante 2,500
182dd106: posts small blind 8,000
c9563272: posts big blind 16,000
*** HOLE CARDS ***
Dealt to 29cb19d7 
Dealt to a32338e3 
Dealt to 182dd106 
Dealt to c9563272 
Dealt to Hero [Tc 9s]
Hero: folds
29cb19d7: folds
a32338e3: folds
182dd106: folds
Uncalled bet (8,000) returned to c9563272
*** SHOWDOWN ***
c9563272 collected 28,500 from pot
*** SUMMARY ***
Total pot 28,500 | Rake 0 | Jackpot 0 | Bingo 0 | Fortune 0 | Tax 0
Seat 1: 29cb19d7 folded before Flop
Seat 2: a32338e3 (button) folded before Flop
Seat 4: 182dd106 (small blind) folded before Flop
Seat 5: c9563272 (big blind) collected (28,500)
Seat 6: Hero folded before Flop


Poker Hand #TM4180647522: Tournament #187165250, Mini Hypersonic $2.50 Hold'em No Limit - Level31(8,000/16,000) - 2025/02/03 18:05:44
Table '40' 6-max Seat #1 is the button
Seat 1: 29cb19d7 (414,319 in chips)
Seat 2: a32338e3 (244,332 in chips)
Seat 4: 182dd106 (364,612 in chips)
Seat 5: c9563272 (229,394 in chips)
Seat 6: Hero (305,539 in chips)
29cb19d7: posts the ante 2,500
Hero: posts the ante 2,500
a32338e3: posts the ante 2,500
c9563272: posts the ante 2,500
182dd106: posts the ante 2,500
a32338e3: posts small blind 8,000
182dd106: posts big blind 16,000
*** HOLE CARDS ***
Dealt to 29cb19d7 
Dealt to a32338e3 
Dealt to 182dd106 
Dealt to c9563272 
Dealt to Hero [Qh 3d]
c9563272: folds
Hero: folds
29cb19d7: folds
a32338e3: folds
Uncalled bet (8,000) returned to 182dd106
*** SHOWDOWN ***
182dd106 collected 28,500 from pot
*** SUMMARY ***
Total pot 28,500 | Rake 0 | Jackpot 0 | Bingo 0 | Fortune 0 | Tax 0
Seat 1: 29cb19d7 (button) folded before Flop
Seat 2: a32338e3 (small blind) folded before Flop
Seat 4: 182dd106 (big blind) collected (28,500)
Seat 5: c9563272 folded before Flop
Seat 6: Hero folded before Flop


Poker Hand #TM4180647489: Tournament #187165250, Mini Hypersonic $2.50 Hold'em No Limit - Level31(8,000/16,000) - 2025/02/03 18:04:59
Table '40' 6-max Seat #6 is the button
Seat 1: 29cb19d7 (356,319 in chips)
Seat 2: a32338e3 (262,832 in chips)
Seat 4: 182dd106 (367,112 in chips)
Seat 5: c9563272 (231,894 in chips)
Seat 6: Hero (340,039 in chips)
29cb19d7: posts the ante 2,500
Hero: posts the ante 2,500
a32338e3: posts the ante 2,500
c9563272: posts the ante 2,500
182dd106: posts the ante 2,500
29cb19d7: posts small blind 8,000
a32338e3: posts big blind 16,000
*** HOLE CARDS ***
Dealt to 29cb19d7 
Dealt to a32338e3 
Dealt to 182dd106 
Dealt to c9563272 
Dealt to Hero [As 5h]
182dd106: folds
c9563272: folds
Hero: raises 16,000 to 32,000
29cb19d7: calls 24,000
a32338e3: folds
*** FLOP *** [7d 6h Th]
29cb19d7: checks
Hero: checks
*** TURN *** [7d 6h Th] [7c]
29cb19d7: bets 46,250
Hero: folds
Uncalled bet (46,250) returned to 29cb19d7
*** SHOWDOWN ***
29cb19d7 collected 92,500 from pot
*** SUMMARY ***
Total pot 92,500 | Rake 0 | Jackpot 0 | Bingo 0 | Fortune 0 | Tax 0
Board [7d 6h Th 7c]
Seat 1: 29cb19d7 (small blind) won (92,500)
Seat 2: a32338e3 (big blind) folded before Flop
Seat 4: 182dd106 folded before Flop
Seat 5: c9563272 folded before Flop
Seat 6: Hero (button) folded on the Turn


Poker Hand #TM4180647466: Tournament #187165250, Mini Hypersonic $2.50 Hold'em No Limit - Level31(8,000/16,000) - 2025/02/03 18:04:29
Table '40' 6-max Seat #5 is the button
Seat 1: 29cb19d7 (374,819 in chips)
Seat 2: a32338e3 (265,332 in chips)
Seat 4: 182dd106 (333,112 in chips)
Seat 5: c9563272 (234,394 in chips)
Seat 6: Hero (350,539 in chips)
29cb19d7: posts the ante 2,500
Hero: posts the ante 2,500
a32338e3: posts the ante 2,500
c9563272: posts the ante 2,500
182dd106: posts the ante 2,500
Hero: posts small blind 8,000
29cb19d7: posts big blind 16,000
*** HOLE CARDS ***
Dealt to 29cb19d7 
Dealt to a32338e3 
Dealt to 182dd106 
Dealt to c9563272 
Dealt to Hero [8s 6s]
a32338e3: folds
182dd106: raises 16,000 to 32,000
c9563272: folds
Hero: folds
29cb19d7: folds
Uncalled bet (16,000) returned to 182dd106
*** SHOWDOWN ***
182dd106 collected 52,500 from pot
*** SUMMARY ***
Total pot 52,500 | Rake 0 | Jackpot 0 | Bingo 0 | Fortune 0 | Tax 0
Seat 1: 29cb19d7 (big blind) folded before Flop
Seat 2: a32338e3 folded before Flop
Seat 4: 182dd106 collected (52,500)
Seat 5: c9563272 (button) folded before Flop
Seat 6: Hero (small blind) folded before Flop


Poker Hand #TM4180647455: Tournament #187165250, Mini Hypersonic $2.50 Hold'em No Limit - Level31(8,000/16,000) - 2025/02/03 18:04:13
Table '40' 6-max Seat #4 is the button
Seat 1: 29cb19d7 (377,319 in chips)
Seat 2: a32338e3 (267,832 in chips)
Seat 4: 182dd106 (335,612 in chips)
Seat 5: c9563272 (244,894 in chips)
Seat 6: Hero (332,539 in chips)
29cb19d7: posts the ante 2,500
Hero: posts the ante 2,500
a32338e3: posts the ante 2,500
182dd106: posts the ante 2,500
c9563272: posts the ante 2,500
c9563272: posts small blind 8,000
Hero: posts big blind 16,000
*** HOLE CARDS ***
Dealt to 29cb19d7 
Dealt to a32338e3 
Dealt to 182dd106 
Dealt to c9563272 
Dealt to Hero [Jc 5c]
29cb19d7: folds
a32338e3: folds
182dd106: folds
c9563272: folds
Uncalled bet (8,000) returned to Hero
*** SHOWDOWN ***
Hero collected 28,500 from pot
*** SUMMARY ***
Total pot 28,500 | Rake 0 | Jackpot 0 | Bingo 0 | Fortune 0 | Tax 0
Seat 1: 29cb19d7 folded before Flop
Seat 2: a32338e3 folded before Flop
Seat 4: 182dd106 (button) folded before Flop
Seat 5: c9563272 (small blind) folded before Flop
Seat 6: Hero (big blind) collected (28,500)


Poker Hand #TM4180647437: Tournament #187165250, Mini Hypersonic $2.50 Hold'em No Limit - Level31(8,000/16,000) - 2025/02/03 18:03:43
Table '40' 6-max Seat #2 is the button
Seat 1: 29cb19d7 (379,819 in chips)
Seat 2: a32338e3 (270,332 in chips)
Seat 4: 182dd106 (309,612 in chips)
Seat 5: c9563272 (263,394 in chips)
Seat 6: Hero (335,039 in chips)
29cb19d7: posts the ante 2,500
Hero: posts the ante 2,500
a32338e3: posts the ante 2,500
c9563272: posts the ante 2,500
182dd106: posts the ante 2,500
182dd106: posts small blind 8,000
c9563272: posts big blind 16,000
*** HOLE CARDS ***
Dealt to 29cb19d7 
Dealt to a32338e3 
Dealt to 182dd106 
Dealt to c9563272 
Dealt to Hero [Th Jc]
Hero: folds
29cb19d7: folds
a32338e3: folds
182dd106: calls 8,000
c9563272: checks
*** FLOP *** [Tc Jh 7h]
182dd106: bets 22,250
c9563272: folds
Uncalled bet (22,250) returned to 182dd106
*** SHOWDOWN ***
182dd106 collected 44,500 from pot
*** SUMMARY ***
Total pot 44,500 | Rake 0 | Jackpot 0 | Bingo 0 | Fortune 0 | Tax 0
Board [Tc Jh 7h]
Seat 1: 29cb19d7 folded before Flop
Seat 2: a32338e3 (button) folded before Flop
Seat 4: 182dd106 (small blind) won (44,500)
Seat 5: c9563272 (big blind) folded on the Flop
Seat 6: Hero folded before Flop


Poker Hand #TM4180647423: Tournament #187165250, Mini Hypersonic $2.50 Hold'em No Limit - Level31(8,000/16,000) - 2025/02/03 18:03:22
Table '40' 6-max Seat #1 is the button
Seat 1: 29cb19d7 (382,319 in chips)
Seat 2: a32338e3 (280,832 in chips)
Seat 4: 182dd106 (328,112 in chips)
Seat 5: c9563272 (265,894 in chips)
Seat 6: Hero (301,039 in chips)
29cb19d7: posts the ante 2,500
Hero: posts the ante 2,500
a32338e3: posts the ante 2,500
c9563272: posts the ante 2,500
182dd106: posts the ante 2,500
a32338e3: posts small blind 8,000
182dd106: posts big blind 16,000
*** HOLE CARDS ***
Dealt to 29cb19d7 
Dealt to a32338e3 
Dealt to 182dd106 
Dealt to c9563272 
Dealt to Hero [Kh Qc]
c9563272: folds
Hero: raises 16,000 to 32,000
29cb19d7: folds
a32338e3: folds
182dd106: folds
Uncalled bet (16,000) returned to Hero
*** SHOWDOWN ***
Hero collected 52,500 from pot
*** SUMMARY ***
Total pot 52,500 | Rake 0 | Jackpot 0 | Bingo 0 | Fortune 0 | Tax 0
Seat 1: 29cb19d7 (button) folded before Flop
Seat 2: a32338e3 (small blind) folded before Flop
Seat 4: 182dd106 (big blind) folded before Flop
Seat 5: c9563272 folded before Flop
Seat 6: Hero collected (52,500)


Poker Hand #TM4180647395: Tournament #187165250, Mini Hypersonic $2.50 Hold'em No Limit - Level30(7,000/14,000) - 2025/02/03 18:02:48
Table '40' 6-max Seat #6 is the button
Seat 1: 29cb19d7 (360,319 in chips)
Seat 2: a32338e3 (296,832 in chips)
Seat 4: 182dd106 (330,112 in chips)
Seat 5: c9563272 (267,894 in chips)
Seat 6: Hero (303,039 in chips)
29cb19d7: posts the ante 2,000
Hero: posts the ante 2,000
a32338e3: posts the ante 2,000
c9563272: posts the ante 2,000
182dd106: posts the ante 2,000
29cb19d7: posts small blind 7,000
a32338e3: posts big blind 14,000
*** HOLE CARDS ***
Dealt to 29cb19d7 
Dealt to a32338e3 
Dealt to 182dd106 
Dealt to c9563272 
Dealt to Hero [5c 4d]
182dd106: folds
c9563272: folds
Hero: folds
29cb19d7: calls 7,000
a32338e3: checks
*** FLOP *** [2s Qd Jc]
29cb19d7: bets 19,000
a32338e3: folds
Uncalled bet (19,000) returned to 29cb19d7
*** SHOWDOWN ***
29cb19d7 collected 38,000 from pot
*** SUMMARY ***
Total pot 38,000 | Rake 0 | Jackpot 0 | Bingo 0 | Fortune 0 | Tax 0
Board [2s Qd Jc]
Seat 1: 29cb19d7 (small blind) won (38,000)
Seat 2: a32338e3 (big blind) folded on the Flop
Seat 4: 182dd106 folded before Flop
Seat 5: c9563272 folded before Flop
Seat 6: Hero (button) folded before Flop


Poker Hand #TM4180647358: Tournament #187165250, Mini Hypersonic $2.50 Hold'em No Limit - Level30(7,000/14,000) - 2025/02/03 18:01:58
Table '40' 6-max Seat #5 is the button
Seat 1: 29cb19d7 (376,319 in chips)
Seat 2: a32338e3 (298,832 in chips)
Seat 4: 182dd106 (332,112 in chips)
Seat 5: c9563272 (269,894 in chips)
Seat 6: Hero (281,039 in chips)
29cb19d7: posts the ante 2,000
Hero: posts the ante 2,000
a32338e3: posts the ante 2,000
c9563272: posts the ante 2,000
182dd106: posts the ante 2,000
Hero: posts small blind 7,000
29cb19d7: posts big blind 14,000
*** HOLE CARDS ***
Dealt to 29cb19d7 
Dealt to a32338e3 
Dealt to 182dd106 
Dealt to c9563272 
Dealt to Hero [9h Td]
a32338e3: folds
182dd106: folds
c9563272: folds
Hero: calls 7,000
29cb19d7: checks
*** FLOP *** [Jh 9c 7s]
Hero: checks
29cb19d7: checks
*** TURN *** [Jh 9c 7s] [Ad]
Hero: checks
29cb19d7: checks
*** RIVER *** [Jh 9c 7s Ad] [2h]
Hero: bets 19,000
29cb19d7: folds
Uncalled bet (19,000) returned to Hero
*** SHOWDOWN ***
Hero collected 38,000 from pot
*** SUMMARY ***
Total pot 38,000 | Rake 0 | Jackpot 0 | Bingo 0 | Fortune 0 | Tax 0
Board [Jh 9c 7s Ad 2h]
Seat 1: 29cb19d7 (big blind) folded on the River
Seat 2: a32338e3 folded before Flop
Seat 4: 182dd106 folded before Flop
Seat 5: c9563272 (button) folded before Flop
Seat 6: Hero (small blind) won (38,000)


Poker Hand #TM4180647354: Tournament #187165250, Mini Hypersonic $2.50 Hold'em No Limit - Level30(7,000/14,000) - 2025/02/03 18:01:43
Table '40' 6-max Seat #4 is the button
Seat 1: 29cb19d7 (378,319 in chips)
Seat 2: a32338e3 (300,832 in chips)
Seat 4: 182dd106 (334,112 in chips)
Seat 5: c9563272 (278,894 in chips)
Seat 6: Hero (266,039 in chips)
29cb19d7: posts the ante 2,000
Hero: posts the ante 2,000
a32338e3: posts the ante 2,000
182dd106: posts the ante 2,000
c9563272: posts the ante 2,000
c9563272: posts small blind 7,000
Hero: posts big blind 14,000
*** HOLE CARDS ***
Dealt to 29cb19d7 
Dealt to a32338e3 
Dealt to 182dd106 
Dealt to c9563272 
Dealt to Hero [Jh 2h]
29cb19d7: folds
a32338e3: folds
182dd106: folds
c9563272: folds
Uncalled bet (7,000) returned to Hero
*** SHOWDOWN ***
Hero collected 24,000 from pot
*** SUMMARY ***
Total pot 24,000 | Rake 0 | Jackpot 0 | Bingo 0 | Fortune 0 | Tax 0
Seat 1: 29cb19d7 folded before Flop
Seat 2: a32338e3 folded before Flop
Seat 4: 182dd106 (button) folded before Flop
Seat 5: c9563272 (small blind) folded before Flop
Seat 6: Hero (big blind) collected (24,000)


Poker Hand #TM4180647332: Tournament #187165250, Mini Hypersonic $2.50 Hold'em No Limit - Level30(7,000/14,000) - 2025/02/03 18:01:04
Table '40' 6-max Seat #2 is the button
Seat 1: 29cb19d7 (380,319 in chips)
Seat 2: a32338e3 (302,832 in chips)
Seat 3: 9f23f453 (62,632 in chips)
Seat 4: 182dd106 (263,480 in chips)
Seat 5: c9563272 (280,894 in chips)
Seat 6: Hero (268,039 in chips)
29cb19d7: posts the ante 2,000
Hero: posts the ante 2,000
a32338e3: posts the ante 2,000
c9563272: posts the ante 2,000
182dd106: posts the ante 2,000
9f23f453: posts the ante 2,000
9f23f453: posts small blind 7,000
182dd106: posts big blind 14,000
*** HOLE CARDS ***
Dealt to 29cb19d7 
Dealt to a32338e3 
Dealt to 9f23f453 
Dealt to 182dd106 
Dealt to c9563272 
Dealt to Hero [4h 5s]
c9563272: folds
Hero: folds
29cb19d7: folds
a32338e3: folds
9f23f453: raises 46,632 to 60,632 and is all-in
182dd106: calls 46,632
9f23f453: shows [9s Qs]
182dd106: shows [Ad 6c]
*** FLOP *** [2d 3s 2h]
*** TURN *** [2d 3s 2h] [8s]
*** RIVER *** [2d 3s 2h 8s] [3c]
*** SHOWDOWN ***
182dd106 collected 133,264 from pot
*** SUMMARY ***
Total pot 133,264 | Rake 0 | Jackpot 0 | Bingo 0 | Fortune 0 | Tax 0
Board [2d 3s 2h 8s 3c]
Seat 1: 29cb19d7 folded before Flop
Seat 2: a32338e3 (button) folded before Flop
Seat 3: 9f23f453 (small blind) showed [9s Qs] and lost with Pair of Treys and Pair of Twos
Seat 4: 182dd106 (big blind) showed [Ad 6c] and won (133,264) with Pair of Treys and Pair of Twos
Seat 5: c9563272 folded before Flop
Seat 6: Hero folded before Flop


Poker Hand #TM4180647325: Tournament #187165250, Mini Hypersonic $2.50 Hold'em No Limit - Level30(7,000/14,000) - 2025/02/03 18:00:32
Table '40' 6-max Seat #1 is the button
Seat 1: 29cb19d7 (349,319 in chips)
Seat 2: a32338e3 (311,832 in chips)
Seat 3: 9f23f453 (78,632 in chips)
Seat 4: 182dd106 (265,480 in chips)
Seat 5: c9563272 (282,894 in chips)
Seat 6: Hero (270,039 in chips)
29cb19d7: posts the ante 2,000
Hero: posts the ante 2,000
a32338e3: posts the ante 2,000
c9563272: posts the ante 2,000
182dd106: posts the ante 2,000
9f23f453: posts the ante 2,000
a32338e3: posts small blind 7,000
9f23f453: posts big blind 14,000
*** HOLE CARDS ***
Dealt to 29cb19d7 
Dealt to a32338e3 
Dealt to 9f23f453 
Dealt to 182dd106 
Dealt to c9563272 
Dealt to Hero [8d Ts]
182dd106: folds
c9563272: folds
Hero: folds
29cb19d7: raises 14,000 to 28,000
a32338e3: folds
9f23f453: folds
Uncalled bet (14,000) returned to 29cb19d7
*** SHOWDOWN ***
29cb19d7 collected 47,000 from pot
*** SUMMARY ***
Total pot 47,000 | Rake 0 | Jackpot 0 | Bingo 0 | Fortune 0 | Tax 0
Seat 1: 29cb19d7 (button) collected (47,000)
Seat 2: a32338e3 (small blind) folded before Flop
Seat 3: 9f23f453 (big blind) folded before Flop
Seat 4: 182dd106 folded before Flop
Seat 5: c9563272 folded before Flop
Seat 6: Hero folded before Flop


Poker Hand #TM4180647316: Tournament #187165250, Mini Hypersonic $2.50 Hold'em No Limit - Level30(7,000/14,000) - 2025/02/03 17:54:48
Table '40' 6-max Seat #6 is the button
Seat 1: 29cb19d7 (358,319 in chips)
Seat 2: a32338e3 (327,832 in chips)
Seat 3: 9f23f453 (80,632 in chips)
Seat 4: 182dd106 (267,480 in chips)
Seat 5: c9563272 (312,894 in chips)
Seat 6: Hero (211,039 in chips)
29cb19d7: posts the ante 2,000
Hero: posts the ante 2,000
a32338e3: posts the ante 2,000
c9563272: posts the ante 2,000
182dd106: posts the ante 2,000
9f23f453: posts the ante 2,000
29cb19d7: posts small blind 7,000
a32338e3: posts big blind 14,000
*** HOLE CARDS ***
Dealt to 29cb19d7 
Dealt to a32338e3 
Dealt to 9f23f453 
Dealt to 182dd106 
Dealt to c9563272 
Dealt to Hero [Ac Qs]
9f23f453: folds
182dd106: folds
c9563272: raises 14,000 to 28,000
Hero: raises 181,039 to 209,039 and is all-in
29cb19d7: folds
a32338e3: folds
c9563272: folds
Uncalled bet (181,039) returned to Hero
*** SHOWDOWN ***
Hero collected 89,000 from pot
*** SUMMARY ***
Total pot 89,000 | Rake 0 | Jackpot 0 | Bingo 0 | Fortune 0 | Tax 0
Seat 1: 29cb19d7 (small blind) folded before Flop
Seat 2: a32338e3 (big blind) folded before Flop
Seat 3: 9f23f453 folded before Flop
Seat 4: 182dd106 folded before Flop
Seat 5: c9563272 folded before Flop
Seat 6: Hero (button) collected (89,000)


Poker Hand #TM4180647288: Tournament #187165250, Mini Hypersonic $2.50 Hold'em No Limit - Level30(7,000/14,000) - 2025/02/03 17:53:49
Table '40' 6-max Seat #5 is the button
Seat 1: 29cb19d7 (374,319 in chips)
Seat 2: a32338e3 (237,832 in chips)
Seat 4: 182dd106 (269,480 in chips)
Seat 5: c9563272 (314,894 in chips)
Seat 6: Hero (281,039 in chips)
29cb19d7: posts the ante 2,000
Hero: posts the ante 2,000
a32338e3: posts the ante 2,000
c9563272: posts the ante 2,000
182dd106: posts the ante 2,000
Hero: posts small blind 7,000
29cb19d7: posts big blind 14,000
*** HOLE CARDS ***
Dealt to 29cb19d7 
Dealt to a32338e3 
Dealt to 182dd106 
Dealt to c9563272 
Dealt to Hero [Kh 9h]
a32338e3: raises 14,000 to 28,000
182dd106: folds
c9563272: folds
Hero: calls 21,000
29cb19d7: folds
*** FLOP *** [2h Js Qd]
Hero: checks
a32338e3: bets 40,000
Hero: calls 40,000
*** TURN *** [2h Js Qd] [3c]
Hero: checks
a32338e3: bets 56,000
Hero: folds
Uncalled bet (56,000) returned to a32338e3
*** SHOWDOWN ***
a32338e3 collected 160,000 from pot
*** SUMMARY ***
Total pot 160,000 | Rake 0 | Jackpot 0 | Bingo 0 | Fortune 0 | Tax 0
Board [2h Js Qd 3c]
Seat 1: 29cb19d7 (big blind) folded before Flop
Seat 2: a32338e3 won (160,000)
Seat 4: 182dd106 folded before Flop
Seat 5: c9563272 (button) folded before Flop
Seat 6: Hero (small blind) folded on the Turn


Poker Hand #TM4180647277: Tournament #187165250, Mini Hypersonic $2.50 Hold'em No Limit - Level30(7,000/14,000) - 2025/02/03 17:53:33
Table '40' 6-max Seat #4 is the button
Seat 1: 29cb19d7 (376,319 in chips)
Seat 2: a32338e3 (239,832 in chips)
Seat 4: 182dd106 (271,480 in chips)
Seat 5: c9563272 (323,894 in chips)
Seat 6: Hero (266,039 in chips)
29cb19d7: posts the ante 2,000
Hero: posts the ante 2,000
a32338e3: posts the ante 2,000
182dd106: posts the ante 2,000
c9563272: posts the ante 2,000
c9563272: posts small blind 7,000
Hero: posts big blind 14,000
*** HOLE CARDS ***
Dealt to 29cb19d7 
Dealt to a32338e3 
Dealt to 182dd106 
Dealt to c9563272 
Dealt to Hero [9c 5c]
29cb19d7: folds
a32338e3: folds
182dd106: folds
c9563272: folds
Uncalled bet (7,000) returned to Hero
*** SHOWDOWN ***
Hero collected 24,000 from pot
*** SUMMARY ***
Total pot 24,000 | Rake 0 | Jackpot 0 | Bingo 0 | Fortune 0 | Tax 0
Seat 1: 29cb19d7 folded before Flop
Seat 2: a32338e3 folded before Flop
Seat 4: 182dd106 (button) folded before Flop
Seat 5: c9563272 (small blind) folded before Flop
Seat 6: Hero (big blind) collected (24,000)


Poker Hand #TM4180647258: Tournament #187165250, Mini Hypersonic $2.50 Hold'em No Limit - Level29(6,000/12,000) - 2025/02/03 17:52:53
Table '40' 6-max Seat #3 is the button
Seat 1: 29cb19d7 (378,119 in chips)
Seat 2: a32338e3 (241,632 in chips)
Seat 3: 6c40dc27 (153,912 in chips)
Seat 4: 182dd106 (126,140 in chips)
Seat 5: c9563272 (337,694 in chips)
Seat 6: Hero (267,839 in chips)
6c40dc27: posts the ante 1,800
29cb19d7: posts the ante 1,800
Hero: posts the ante 1,800
a32338e3: posts the ante 1,800
c9563272: posts the ante 1,800
182dd106: posts the ante 1,800
182dd106: posts small blind 6,000
c9563272: posts big blind 12,000
*** HOLE CARDS ***
Dealt to 29cb19d7 
Dealt to a32338e3 
Dealt to 6c40dc27 
Dealt to 182dd106 
Dealt to c9563272 
Dealt to Hero [9h Jh]
Hero: folds
29cb19d7: folds
a32338e3: folds
6c40dc27: raises 140,112 to 152,112 and is all-in
182dd106: calls 118,340 and is all-in
c9563272: folds
Uncalled bet (27,772) returned to 6c40dc27
6c40dc27: shows [Th Js]
182dd106: shows [Kc Ac]
*** FLOP *** [8d Qd 6c]
*** TURN *** [8d Qd 6c] [Qc]
*** RIVER *** [8d Qd 6c Qc] [2d]
*** SHOWDOWN ***
182dd106 collected 271,480 from pot
*** SUMMARY ***
Total pot 271,480 | Rake 0 | Jackpot 0 | Bingo 0 | Fortune 0 | Tax 0
Board [8d Qd 6c Qc 2d]
Seat 1: 29cb19d7 folded before Flop
Seat 2: a32338e3 folded before Flop
Seat 3: 6c40dc27 (button) showed [Th Js] and lost with Pair of Queens
Seat 4: 182dd106 (small blind) showed [Kc Ac] and won (271,480) with Pair of Queens
Seat 5: c9563272 (big blind) folded before Flop
Seat 6: Hero folded before Flop


Poker Hand #TM4180647248: Tournament #187165250, Mini Hypersonic $2.50 Hold'em No Limit - Level29(6,000/12,000) - 2025/02/03 17:52:37
Table '40' 6-max Seat #2 is the button
Seat 1: 29cb19d7 (379,919 in chips)
Seat 2: a32338e3 (243,432 in chips)
Seat 3: 6c40dc27 (161,712 in chips)
Seat 4: 182dd106 (139,940 in chips)
Seat 5: c9563272 (339,494 in chips)
Seat 6: Hero (240,839 in chips)
29cb19d7: posts the ante 1,800
6c40dc27: posts the ante 1,800
Hero: posts the ante 1,800
a32338e3: posts the ante 1,800
c9563272: posts the ante 1,800
182dd106: posts the ante 1,800
6c40dc27: posts small blind 6,000
182dd106: posts big blind 12,000
*** HOLE CARDS ***
Dealt to 29cb19d7 
Dealt to a32338e3 
Dealt to 6c40dc27 
Dealt to 182dd106 
Dealt to c9563272 
Dealt to Hero [Js Qs]
c9563272: folds
Hero: raises 12,000 to 24,000
29cb19d7: folds
a32338e3: folds
6c40dc27: folds
182dd106: folds
Uncalled bet (12,000) returned to Hero
*** SHOWDOWN ***
Hero collected 40,800 from pot
*** SUMMARY ***
Total pot 40,800 | Rake 0 | Jackpot 0 | Bingo 0 | Fortune 0 | Tax 0
Seat 1: 29cb19d7 folded before Flop
Seat 2: a32338e3 (button) folded before Flop
Seat 3: 6c40dc27 (small blind) folded before Flop
Seat 4: 182dd106 (big blind) folded before Flop
Seat 5: c9563272 folded before Flop
Seat 6: Hero collected (40,800)


Poker Hand #TM4180647239: Tournament #187165250, Mini Hypersonic $2.50 Hold'em No Limit - Level29(6,000/12,000) - 2025/02/03 17:52:19
Table '40' 6-max Seat #1 is the button
Seat 1: 29cb19d7 (381,719 in chips)
Seat 2: a32338e3 (251,232 in chips)
Seat 3: 6c40dc27 (175,512 in chips)
Seat 4: 182dd106 (112,940 in chips)
Seat 5: c9563272 (341,294 in chips)
Seat 6: Hero (242,639 in chips)
29cb19d7: posts the ante 1,800
6c40dc27: posts the ante 1,800
Hero: posts the ante 1,800
a32338e3: posts the ante 1,800
c9563272: posts the ante 1,800
182dd106: posts the ante 1,800
a32338e3: posts small blind 6,000
6c40dc27: posts big blind 12,000
*** HOLE CARDS ***
Dealt to 29cb19d7 
Dealt to a32338e3 
Dealt to 6c40dc27 
Dealt to 182dd106 
Dealt to c9563272 
Dealt to Hero [6h Jc]
182dd106: raises 99,140 to 111,140 and is all-in
c9563272: folds
Hero: folds
29cb19d7: folds
a32338e3: folds
6c40dc27: folds
Uncalled bet (99,140) returned to 182dd106
*** SHOWDOWN ***
182dd106 collected 40,800 from pot
*** SUMMARY ***
Total pot 40,800 | Rake 0 | Jackpot 0 | Bingo 0 | Fortune 0 | Tax 0
Seat 1: 29cb19d7 (button) folded before Flop
Seat 2: a32338e3 (small blind) folded before Flop
Seat 3: 6c40dc27 (big blind) folded before Flop
Seat 4: 182dd106 collected (40,800)
Seat 5: c9563272 folded before Flop
Seat 6: Hero folded before Flop


Poker Hand #TM4180794792: Tournament #187165250, Mini Hypersonic $2.50 Hold'em No Limit - Level29(6,000/12,000) - 2025/02/03 17:51:24
Table '81' 6-max Seat #5 is the button
Seat 1: Hero (256,439 in chips)
Seat 2: 75e17a82 (28,744 in chips)
Seat 3: d6f7406f (421,405 in chips)
Seat 5: e4269ac0 (388,739 in chips)
Seat 6: f7905baa (470,317 in chips)
f7905baa: posts the ante 1,800
Hero: posts the ante 1,800
e4269ac0: posts the ante 1,800
75e17a82: posts the ante 1,800
d6f7406f: posts the ante 1,800
f7905baa: posts small blind 6,000
Hero: posts big blind 12,000
*** HOLE CARDS ***
Dealt to Hero [Qc 4h]
Dealt to 75e17a82 
Dealt to d6f7406f 
Dealt to e4269ac0 
Dealt to f7905baa 
75e17a82: raises 14,944 to 26,944 and is all-in
d6f7406f: folds
e4269ac0: folds
f7905baa: raises 441,573 to 468,517 and is all-in
Hero: folds
Uncalled bet (441,573) returned to f7905baa
f7905baa: shows [Tc Td]
75e17a82: shows [As 9c]
*** FLOP *** [7s 4c Ts]
*** TURN *** [7s 4c Ts] [2h]
*** RIVER *** [7s 4c Ts 2h] [Th]
*** SHOWDOWN ***
f7905baa collected 74,888 from pot
*** SUMMARY ***
Total pot 74,888 | Rake 0 | Jackpot 0 | Bingo 0 | Fortune 0 | Tax 0
Board [7s 4c Ts 2h Th]
Seat 1: Hero (big blind) folded before Flop
Seat 2: 75e17a82 showed [As 9c] and lost with Pair of Tens
Seat 3: d6f7406f folded before Flop
Seat 5: e4269ac0 (button) folded before Flop
Seat 6: f7905baa (small blind) showed [Tc Td] and won (74,888) with Four Tens


Poker Hand #TM4180794776: Tournament #187165250, Mini Hypersonic $2.50 Hold'em No Limit - Level29(6,000/12,000) - 2025/02/03 17:50:53
Table '81' 6-max Seat #3 is the button
Seat 1: Hero (258,239 in chips)
Seat 2: 75e17a82 (30,544 in chips)
Seat 3: d6f7406f (423,205 in chips)
Seat 5: e4269ac0 (396,539 in chips)
Seat 6: f7905baa (457,117 in chips)
f7905baa: posts the ante 1,800
Hero: posts the ante 1,800
e4269ac0: posts the ante 1,800
75e17a82: posts the ante 1,800
d6f7406f: posts the ante 1,800
e4269ac0: posts small blind 6,000
f7905baa: posts big blind 12,000
*** HOLE CARDS ***
Dealt to Hero [7c 2h]
Dealt to 75e17a82 
Dealt to d6f7406f 
Dealt to e4269ac0 
Dealt to f7905baa 
Hero: folds
75e17a82: folds
d6f7406f: folds
e4269ac0: folds
Uncalled bet (6,000) returned to f7905baa
*** SHOWDOWN ***
f7905baa collected 21,000 from pot
*** SUMMARY ***
Total pot 21,000 | Rake 0 | Jackpot 0 | Bingo 0 | Fortune 0 | Tax 0
Seat 1: Hero folded before Flop
Seat 2: 75e17a82 folded before Flop
Seat 3: d6f7406f (button) folded before Flop
Seat 5: e4269ac0 (small blind) folded before Flop
Seat 6: f7905baa (big blind) collected (21,000)


Poker Hand #TM4180794754: Tournament #187165250, Mini Hypersonic $2.50 Hold'em No Limit - Level29(6,000/12,000) - 2025/02/03 17:50:15
Table '81' 6-max Seat #2 is the button
Seat 1: Hero (260,039 in chips)
Seat 2: 75e17a82 (32,344 in chips)
Seat 3: d6f7406f (404,005 in chips)
Seat 5: e4269ac0 (410,339 in chips)
Seat 6: f7905baa (458,917 in chips)
f7905baa: posts the ante 1,800
Hero: posts the ante 1,800
e4269ac0: posts the ante 1,800
75e17a82: posts the ante 1,800
d6f7406f: posts the ante 1,800
d6f7406f: posts small blind 6,000
e4269ac0: posts big blind 12,000
*** HOLE CARDS ***
Dealt to Hero [Qc 5s]
Dealt to 75e17a82 
Dealt to d6f7406f 
Dealt to e4269ac0 
Dealt to f7905baa 
f7905baa: folds
Hero: folds
75e17a82: folds
d6f7406f: calls 6,000
e4269ac0: checks
*** FLOP *** [Ah Js 7d]
d6f7406f: bets 16,500
e4269ac0: folds
Uncalled bet (16,500) returned to d6f7406f
*** SHOWDOWN ***
d6f7406f collected 33,000 from pot
*** SUMMARY ***
Total pot 33,000 | Rake 0 | Jackpot 0 | Bingo 0 | Fortune 0 | Tax 0
Board [Ah Js 7d]
Seat 1: Hero folded before Flop
Seat 2: 75e17a82 (button) folded before Flop
Seat 3: d6f7406f (small blind) won (33,000)
Seat 5: e4269ac0 (big blind) folded on the Flop
Seat 6: f7905baa folded before Flop


Poker Hand #TM4180794729: Tournament #187165250, Mini Hypersonic $2.50 Hold'em No Limit - Level28(5,000/10,000) - 2025/02/03 17:49:18
Table '81' 6-max Seat #1 is the button
Seat 1: Hero (261,539 in chips)
Seat 2: 75e17a82 (38,844 in chips)
Seat 3: d6f7406f (359,880 in chips)
Seat 5: e4269ac0 (411,839 in chips)
Seat 6: f7905baa (493,542 in chips)
f7905baa: posts the ante 1,500
Hero: posts the ante 1,500
e4269ac0: posts the ante 1,500
75e17a82: posts the ante 1,500
d6f7406f: posts the ante 1,500
75e17a82: posts small blind 5,000
d6f7406f: posts big blind 10,000
*** HOLE CARDS ***
Dealt to Hero [Jc Td]
Dealt to 75e17a82 
Dealt to d6f7406f 
Dealt to e4269ac0 
Dealt to f7905baa 
e4269ac0: folds
f7905baa: raises 10,000 to 20,000
Hero: folds
75e17a82: folds
d6f7406f: calls 10,000
*** FLOP *** [Ks Tc 3h]
d6f7406f: checks
f7905baa: bets 13,125
d6f7406f: raises 25,988 to 39,113
f7905baa: folds
Uncalled bet (25,988) returned to d6f7406f
*** SHOWDOWN ***
d6f7406f collected 78,750 from pot
*** SUMMARY ***
Total pot 78,750 | Rake 0 | Jackpot 0 | Bingo 0 | Fortune 0 | Tax 0
Board [Ks Tc 3h]
Seat 1: Hero (button) folded before Flop
Seat 2: 75e17a82 (small blind) folded before Flop
Seat 3: d6f7406f (big blind) won (78,750)
Seat 5: e4269ac0 folded before Flop
Seat 6: f7905baa folded on the Flop


Poker Hand #TM4180794712: Tournament #187165250, Mini Hypersonic $2.50 Hold'em No Limit - Level28(5,000/10,000) - 2025/02/03 17:48:42
Table '81' 6-max Seat #5 is the button
Seat 1: Hero (268,039 in chips)
Seat 2: 75e17a82 (50,344 in chips)
Seat 3: d6f7406f (340,380 in chips)
Seat 5: e4269ac0 (413,339 in chips)
Hero: posts the ante 1,500
e4269ac0: posts the ante 1,500
75e17a82: posts the ante 1,500
d6f7406f: posts the ante 1,500
Hero: posts small blind 5,000
75e17a82: posts big blind 10,000
*** HOLE CARDS ***
Dealt to Hero [5s 4s]
Dealt to 75e17a82 
Dealt to d6f7406f 
Dealt to e4269ac0 
d6f7406f: raises 10,000 to 20,000
e4269ac0: folds
Hero: folds
75e17a82: folds
Uncalled bet (10,000) returned to d6f7406f
*** SHOWDOWN ***
d6f7406f collected 31,000 from pot
*** SUMMARY ***
Total pot 31,000 | Rake 0 | Jackpot 0 | Bingo 0 | Fortune 0 | Tax 0
Seat 1: Hero (small blind) folded before Flop
Seat 2: 75e17a82 (big blind) folded before Flop
Seat 3: d6f7406f collected (31,000)
Seat 5: e4269ac0 (button) folded before Flop


Poker Hand #TM4180794670: Tournament #187165250, Mini Hypersonic $2.50 Hold'em No Limit - Level28(5,000/10,000) - 2025/02/03 17:47:32
Table '81' 6-max Seat #4 is the button
Seat 1: Hero (279,539 in chips)
Seat 2: 75e17a82 (51,844 in chips)
Seat 3: d6f7406f (361,880 in chips)
Seat 4: 673aab49 (175,361 in chips)
Seat 5: e4269ac0 (203,478 in chips)
Hero: posts the ante 1,500
673aab49: posts the ante 1,500
e4269ac0: posts the ante 1,500
75e17a82: posts the ante 1,500
d6f7406f: posts the ante 1,500
e4269ac0: posts small blind 5,000
Hero: posts big blind 10,000
*** HOLE CARDS ***
Dealt to Hero [Kh Tc]
Dealt to 75e17a82 
Dealt to d6f7406f 
Dealt to 673aab49 
Dealt to e4269ac0 
75e17a82: folds
d6f7406f: raises 10,000 to 20,000
673aab49: raises 153,861 to 173,861 and is all-in
e4269ac0: raises 28,117 to 201,978 and is all-in
Hero: folds
d6f7406f: folds
Uncalled bet (28,117) returned to e4269ac0
e4269ac0: shows [Jd Jc]
673aab49: shows [Qh As]
*** FLOP *** [3s 9d 8s]
*** TURN *** [3s 9d 8s] [5s]
*** RIVER *** [3s 9d 8s 5s] [8d]
*** SHOWDOWN ***
e4269ac0 collected 385,222 from pot
*** SUMMARY ***
Total pot 385,222 | Rake 0 | Jackpot 0 | Bingo 0 | Fortune 0 | Tax 0
Board [3s 9d 8s 5s 8d]
Seat 1: Hero (big blind) folded before Flop
Seat 2: 75e17a82 folded before Flop
Seat 3: d6f7406f folded before Flop
Seat 4: 673aab49 (button) showed [Qh As] and lost with Pair of Eights
Seat 5: e4269ac0 (small blind) showed [Jd Jc] and won (385,222) with Pair of Jacks and Pair of Eights


Poker Hand #TM4180794650: Tournament #187165250, Mini Hypersonic $2.50 Hold'em No Limit - Level28(5,000/10,000) - 2025/02/03 17:46:44
Table '81' 6-max Seat #3 is the button
Seat 1: Hero (281,039 in chips)
Seat 2: 75e17a82 (53,344 in chips)
Seat 3: d6f7406f (290,628 in chips)
Seat 4: 673aab49 (181,861 in chips)
Seat 5: e4269ac0 (214,978 in chips)
Seat 6: 63692cda (50,252 in chips)
Hero: posts the ante 1,500
673aab49: posts the ante 1,500
e4269ac0: posts the ante 1,500
75e17a82: posts the ante 1,500
d6f7406f: posts the ante 1,500
63692cda: posts the ante 1,500
673aab49: posts small blind 5,000
e4269ac0: posts big blind 10,000
*** HOLE CARDS ***
Dealt to Hero [8c As]
Dealt to 75e17a82 
Dealt to d6f7406f 
Dealt to 673aab49 
Dealt to e4269ac0 
Dealt to 63692cda 
63692cda: raises 38,752 to 48,752 and is all-in
Hero: folds
75e17a82: folds
d6f7406f: calls 48,752
673aab49: folds
e4269ac0: folds
63692cda: shows [Td 3d]
d6f7406f: shows [8h 7h]
*** FLOP *** [3c 5h 6s]
*** TURN *** [3c 5h 6s] [9h]
*** RIVER *** [3c 5h 6s 9h] [Qc]
*** SHOWDOWN ***
d6f7406f collected 121,504 from pot
*** SUMMARY ***
Total pot 121,504 | Rake 0 | Jackpot 0 | Bingo 0 | Fortune 0 | Tax 0
Board [3c 5h 6s 9h Qc]
Seat 1: Hero folded before Flop
Seat 2: 75e17a82 folded before Flop
Seat 3: d6f7406f (button) showed [8h 7h] and won (121,504) with Nines-High Straight
Seat 4: 673aab49 (small blind) folded before Flop
Seat 5: e4269ac0 (big blind) folded before Flop
Seat 6: 63692cda showed [Td 3d] and lost with Pair of Treys


Poker Hand #TM4180794622: Tournament #187165250, Mini Hypersonic $2.50 Hold'em No Limit - Level28(5,000/10,000) - 2025/02/03 17:45:36
Table '81' 6-max Seat #2 is the button
Seat 1: Hero (317,289 in chips)
Seat 2: 75e17a82 (54,844 in chips)
Seat 3: d6f7406f (238,378 in chips)
Seat 4: 673aab49 (193,361 in chips)
Seat 5: e4269ac0 (216,478 in chips)
Seat 6: 63692cda (51,752 in chips)
Hero: posts the ante 1,500
673aab49: posts the ante 1,500
e4269ac0: posts the ante 1,500
75e17a82: posts the ante 1,500
63692cda: posts the ante 1,500
d6f7406f: posts the ante 1,500
d6f7406f: posts small blind 5,000
673aab49: posts big blind 10,000
*** HOLE CARDS ***
Dealt to Hero [Ks 7s]
Dealt to 75e17a82 
Dealt to d6f7406f 
Dealt to 673aab49 
Dealt to e4269ac0 
Dealt to 63692cda 
e4269ac0: folds
63692cda: folds
Hero: raises 10,000 to 20,000
75e17a82: folds
d6f7406f: calls 15,000
673aab49: folds
*** FLOP *** [Jh 3c Qs]
d6f7406f: checks
Hero: bets 14,750
d6f7406f: calls 14,750
*** TURN *** [Jh 3c Qs] [6c]
d6f7406f: checks
Hero: checks
*** RIVER *** [Jh 3c Qs 6c] [2s]
d6f7406f: checks
Hero: checks
d6f7406f: shows [9s 9c] (Pair of Nines)
Hero: shows [Ks 7s] (King-High)
*** SHOWDOWN ***
d6f7406f collected 88,500 from pot
*** SUMMARY ***
Total pot 88,500 | Rake 0 | Jackpot 0 | Bingo 0 | Fortune 0 | Tax 0
Board [Jh 3c Qs 6c 2s]
Seat 1: Hero showed [Ks 7s] and lost with King-High
Seat 2: 75e17a82 (button) folded before Flop
Seat 3: d6f7406f (small blind) showed [9s 9c] and won (88,500) with Pair of Nines
Seat 4: 673aab49 (big blind) folded before Flop
Seat 5: e4269ac0 folded before Flop
Seat 6: 63692cda folded before Flop


Poker Hand #TM4180368443: Tournament #187165250, Mini Hypersonic $2.50 Hold'em No Limit - Level27(4,000/8,000) - 2025/02/03 17:43:49
Table '72' 6-max Seat #1 is the button
Seat 1: c7d35a50 (107,947 in chips)
Seat 2: 8a03d81b (76,880 in chips)
Seat 3: a32338e3 (161,916 in chips)
Seat 4: e393edee (191,763 in chips)
Seat 5: 4ecba972 (115,976 in chips)
Seat 6: Hero (318,489 in chips)
Hero: posts the ante 1,200
4ecba972: posts the ante 1,200
a32338e3: posts the ante 1,200
e393edee: posts the ante 1,200
c7d35a50: posts the ante 1,200
8a03d81b: posts the ante 1,200
8a03d81b: posts small blind 4,000
a32338e3: posts big blind 8,000
*** HOLE CARDS ***
Dealt to c7d35a50 
Dealt to 8a03d81b 
Dealt to a32338e3 
Dealt to e393edee 
Dealt to 4ecba972 
Dealt to Hero [9c 6h]
e393edee: raises 16,000 to 24,000
4ecba972: folds
Hero: folds
c7d35a50: raises 82,747 to 106,747 and is all-in
8a03d81b: folds
a32338e3: folds
e393edee: calls 82,747
c7d35a50: shows [As 9h]
e393edee: shows [Qh Ah]
*** FLOP *** [8h 4h Kh]
*** TURN *** [8h 4h Kh] [Qc]
*** RIVER *** [8h 4h Kh Qc] [8s]
*** SHOWDOWN ***
e393edee collected 232,694 from pot
*** SUMMARY ***
Total pot 232,694 | Rake 0 | Jackpot 0 | Bingo 0 | Fortune 0 | Tax 0
Board [8h 4h Kh Qc 8s]
Seat 1: c7d35a50 (button) showed [As 9h] and lost with Pair of Eights
Seat 2: 8a03d81b (small blind) folded before Flop
Seat 3: a32338e3 (big blind) folded before Flop
Seat 4: e393edee showed [Qh Ah] and won (232,694) with Ace High Flush
Seat 5: 4ecba972 folded before Flop
Seat 6: Hero folded before Flop


Poker Hand #TM4180368430: Tournament #187165250, Mini Hypersonic $2.50 Hold'em No Limit - Level27(4,000/8,000) - 2025/02/03 17:43:21
Table '72' 6-max Seat #6 is the button
Seat 1: c7d35a50 (77,947 in chips)
Seat 2: 8a03d81b (86,080 in chips)
Seat 3: a32338e3 (163,116 in chips)
Seat 4: e393edee (192,963 in chips)
Seat 5: 4ecba972 (117,176 in chips)
Seat 6: Hero (335,689 in chips)
Hero: posts the ante 1,200
4ecba972: posts the ante 1,200
a32338e3: posts the ante 1,200
e393edee: posts the ante 1,200
8a03d81b: posts the ante 1,200
c7d35a50: posts the ante 1,200
c7d35a50: posts small blind 4,000
8a03d81b: posts big blind 8,000
*** HOLE CARDS ***
Dealt to c7d35a50 
Dealt to 8a03d81b 
Dealt to a32338e3 
Dealt to e393edee 
Dealt to 4ecba972 
Dealt to Hero [6h Ks]
a32338e3: folds
e393edee: folds
4ecba972: folds
Hero: raises 8,000 to 16,000
c7d35a50: raises 60,747 to 76,747 and is all-in
8a03d81b: folds
Hero: folds
Uncalled bet (60,747) returned to c7d35a50
*** SHOWDOWN ***
c7d35a50 collected 47,200 from pot
*** SUMMARY ***
Total pot 47,200 | Rake 0 | Jackpot 0 | Bingo 0 | Fortune 0 | Tax 0
Seat 1: c7d35a50 (small blind) collected (47,200)
Seat 2: 8a03d81b (big blind) folded before Flop
Seat 3: a32338e3 folded before Flop
Seat 4: e393edee folded before Flop
Seat 5: 4ecba972 folded before Flop
Seat 6: Hero (button) folded before Flop


Poker Hand #TM4180368420: Tournament #187165250, Mini Hypersonic $2.50 Hold'em No Limit - Level27(4,000/8,000) - 2025/02/03 17:42:51
Table '72' 6-max Seat #5 is the button
Seat 1: c7d35a50 (87,147 in chips)
Seat 2: 8a03d81b (87,280 in chips)
Seat 3: a32338e3 (164,316 in chips)
Seat 4: e393edee (174,963 in chips)
Seat 5: 4ecba972 (118,376 in chips)
Seat 6: Hero (340,889 in chips)
Hero: posts the ante 1,200
4ecba972: posts the ante 1,200
a32338e3: posts the ante 1,200
e393edee: posts the ante 1,200
8a03d81b: posts the ante 1,200
c7d35a50: posts the ante 1,200
Hero: posts small blind 4,000
c7d35a50: posts big blind 8,000
*** HOLE CARDS ***
Dealt to c7d35a50 
Dealt to 8a03d81b 
Dealt to a32338e3 
Dealt to e393edee 
Dealt to 4ecba972 
Dealt to Hero [8h 5h]
8a03d81b: folds
a32338e3: folds
e393edee: raises 16,000 to 24,000
4ecba972: folds
Hero: folds
c7d35a50: folds
Uncalled bet (16,000) returned to e393edee
*** SHOWDOWN ***
e393edee collected 27,200 from pot
*** SUMMARY ***
Total pot 27,200 | Rake 0 | Jackpot 0 | Bingo 0 | Fortune 0 | Tax 0
Seat 1: c7d35a50 (big blind) folded before Flop
Seat 2: 8a03d81b folded before Flop
Seat 3: a32338e3 folded before Flop
Seat 4: e393edee collected (27,200)
Seat 5: 4ecba972 (button) folded before Flop
Seat 6: Hero (small blind) folded before Flop


Poker Hand #TM4180368412: Tournament #187165250, Mini Hypersonic $2.50 Hold'em No Limit - Level27(4,000/8,000) - 2025/02/03 17:42:35
Table '72' 6-max Seat #4 is the button
Seat 1: c7d35a50 (88,347 in chips)
Seat 2: 8a03d81b (88,480 in chips)
Seat 3: a32338e3 (165,516 in chips)
Seat 4: e393edee (176,163 in chips)
Seat 5: 4ecba972 (123,576 in chips)
Seat 6: Hero (330,889 in chips)
Hero: posts the ante 1,200
4ecba972: posts the ante 1,200
a32338e3: posts the ante 1,200
e393edee: posts the ante 1,200
8a03d81b: posts the ante 1,200
c7d35a50: posts the ante 1,200
4ecba972: posts small blind 4,000
Hero: posts big blind 8,000
*** HOLE CARDS ***
Dealt to c7d35a50 
Dealt to 8a03d81b 
Dealt to a32338e3 
Dealt to e393edee 
Dealt to 4ecba972 
Dealt to Hero [Ad Qh]
c7d35a50: folds
8a03d81b: folds
a32338e3: folds
e393edee: folds
4ecba972: folds
Uncalled bet (4,000) returned to Hero
*** SHOWDOWN ***
Hero collected 15,200 from pot
*** SUMMARY ***
Total pot 15,200 | Rake 0 | Jackpot 0 | Bingo 0 | Fortune 0 | Tax 0
Seat 1: c7d35a50 folded before Flop
Seat 2: 8a03d81b folded before Flop
Seat 3: a32338e3 folded before Flop
Seat 4: e393edee (button) folded before Flop
Seat 5: 4ecba972 (small blind) folded before Flop
Seat 6: Hero (big blind) showed [Ad Qh] and collected (15,200)


Poker Hand #TM4180368403: Tournament #187165250, Mini Hypersonic $2.50 Hold'em No Limit - Level27(4,000/8,000) - 2025/02/03 17:42:14
Table '72' 6-max Seat #3 is the button
Seat 1: c7d35a50 (89,547 in chips)
Seat 2: 8a03d81b (89,680 in chips)
Seat 3: a32338e3 (166,716 in chips)
Seat 4: e393edee (181,363 in chips)
Seat 5: 4ecba972 (113,576 in chips)
Seat 6: Hero (332,089 in chips)
Hero: posts the ante 1,200
4ecba972: posts the ante 1,200
a32338e3: posts the ante 1,200
e393edee: posts the ante 1,200
8a03d81b: posts the ante 1,200
c7d35a50: posts the ante 1,200
e393edee: posts small blind 4,000
4ecba972: posts big blind 8,000
*** HOLE CARDS ***
Dealt to c7d35a50 
Dealt to 8a03d81b 
Dealt to a32338e3 
Dealt to e393edee 
Dealt to 4ecba972 
Dealt to Hero [9s 3d]
Hero: folds
c7d35a50: folds
8a03d81b: folds
a32338e3: folds
e393edee: folds
Uncalled bet (4,000) returned to 4ecba972
*** SHOWDOWN ***
4ecba972 collected 15,200 from pot
*** SUMMARY ***
Total pot 15,200 | Rake 0 | Jackpot 0 | Bingo 0 | Fortune 0 | Tax 0
Seat 1: c7d35a50 folded before Flop
Seat 2: 8a03d81b folded before Flop
Seat 3: a32338e3 (button) folded before Flop
Seat 4: e393edee (small blind) folded before Flop
Seat 5: 4ecba972 (big blind) collected (15,200)
Seat 6: Hero folded before Flop


Poker Hand #TM4180368395: Tournament #187165250, Mini Hypersonic $2.50 Hold'em No Limit - Level27(4,000/8,000) - 2025/02/03 17:41:56
Table '72' 6-max Seat #1 is the button
Seat 1: c7d35a50 (90,747 in chips)
Seat 3: a32338e3 (171,916 in chips)
Seat 4: e393edee (172,563 in chips)
Seat 5: 4ecba972 (114,776 in chips)
Seat 6: Hero (333,289 in chips)
Hero: posts the ante 1,200
4ecba972: posts the ante 1,200
a32338e3: posts the ante 1,200
e393edee: posts the ante 1,200
c7d35a50: posts the ante 1,200
a32338e3: posts small blind 4,000
e393edee: posts big blind 8,000
*** HOLE CARDS ***
Dealt to c7d35a50 
Dealt to a32338e3 
Dealt to e393edee 
Dealt to 4ecba972 
Dealt to Hero [3d 6c]
4ecba972: folds
Hero: folds
c7d35a50: folds
a32338e3: folds
Uncalled bet (4,000) returned to e393edee
*** SHOWDOWN ***
e393edee collected 14,000 from pot
*** SUMMARY ***
Total pot 14,000 | Rake 0 | Jackpot 0 | Bingo 0 | Fortune 0 | Tax 0
Seat 1: c7d35a50 (button) folded before Flop
Seat 3: a32338e3 (small blind) folded before Flop
Seat 4: e393edee (big blind) collected (14,000)
Seat 5: 4ecba972 folded before Flop
Seat 6: Hero folded before Flop


Poker Hand #TM4180368372: Tournament #187165250, Mini Hypersonic $2.50 Hold'em No Limit - Level26(3,500/7,000) - 2025/02/03 17:40:39
Table '72' 6-max Seat #6 is the button
Seat 1: c7d35a50 (95,247 in chips)
Seat 3: a32338e3 (179,916 in chips)
Seat 4: e393edee (173,563 in chips)
Seat 5: 4ecba972 (210,651 in chips)
Seat 6: Hero (223,914 in chips)
Hero: posts the ante 1,000
4ecba972: posts the ante 1,000
a32338e3: posts the ante 1,000
e393edee: posts the ante 1,000
c7d35a50: posts the ante 1,000
c7d35a50: posts small blind 3,500
a32338e3: posts big blind 7,000
*** HOLE CARDS ***
Dealt to c7d35a50 
Dealt to a32338e3 
Dealt to e393edee 
Dealt to 4ecba972 
Dealt to Hero [Qs Ad]
e393edee: folds
4ecba972: raises 10,500 to 17,500
Hero: raises 24,500 to 42,000
c7d35a50: folds
a32338e3: folds
4ecba972: calls 24,500
*** FLOP *** [Ac Ks 9s]
4ecba972: checks
Hero: bets 24,875
4ecba972: calls 24,875
*** TURN *** [Ac Ks 9s] [3s]
4ecba972: checks
Hero: checks
*** RIVER *** [Ac Ks 9s 3s] [2c]
4ecba972: bets 28,000
Hero: calls 28,000
4ecba972: shows [Qh Kc] (Pair of Kings)
Hero: shows [Qs Ad] (Pair of Aces)
*** SHOWDOWN ***
Hero collected 205,250 from pot
*** SUMMARY ***
Total pot 205,250 | Rake 0 | Jackpot 0 | Bingo 0 | Fortune 0 | Tax 0
Board [Ac Ks 9s 3s 2c]
Seat 1: c7d35a50 (small blind) folded before Flop
Seat 3: a32338e3 (big blind) folded before Flop
Seat 4: e393edee folded before Flop
Seat 5: 4ecba972 showed [Qh Kc] and lost with Pair of Kings
Seat 6: Hero (button) showed [Qs Ad] and won (205,250) with Pair of Aces


Poker Hand #TM4180368348: Tournament #187165250, Mini Hypersonic $2.50 Hold'em No Limit - Level26(3,500/7,000) - 2025/02/03 17:39:52
Table '72' 6-max Seat #5 is the button
Seat 1: c7d35a50 (113,747 in chips)
Seat 3: a32338e3 (180,916 in chips)
Seat 4: e393edee (174,563 in chips)
Seat 5: 4ecba972 (185,651 in chips)
Seat 6: Hero (228,414 in chips)
Hero: posts the ante 1,000
4ecba972: posts the ante 1,000
a32338e3: posts the ante 1,000
e393edee: posts the ante 1,000
c7d35a50: posts the ante 1,000
Hero: posts small blind 3,500
c7d35a50: posts big blind 7,000
*** HOLE CARDS ***
Dealt to c7d35a50 
Dealt to a32338e3 
Dealt to e393edee 
Dealt to 4ecba972 
Dealt to Hero [2d Jh]
a32338e3: folds
e393edee: folds
4ecba972: raises 10,500 to 17,500
Hero: folds
c7d35a50: calls 10,500
*** FLOP *** [9s Qd Ad]
c7d35a50: checks
4ecba972: bets 21,000
c7d35a50: folds
Uncalled bet (21,000) returned to 4ecba972
*** SHOWDOWN ***
4ecba972 collected 43,500 from pot
*** SUMMARY ***
Total pot 43,500 | Rake 0 | Jackpot 0 | Bingo 0 | Fortune 0 | Tax 0
Board [9s Qd Ad]
Seat 1: c7d35a50 (big blind) folded on the Flop
Seat 3: a32338e3 folded before Flop
Seat 4: e393edee folded before Flop
Seat 5: 4ecba972 (button) won (43,500)
Seat 6: Hero (small blind) folded before Flop


Poker Hand #TM4180368331: Tournament #187165250, Mini Hypersonic $2.50 Hold'em No Limit - Level26(3,500/7,000) - 2025/02/03 17:38:58
Table '72' 6-max Seat #4 is the button
Seat 1: c7d35a50 (114,747 in chips)
Seat 3: a32338e3 (209,916 in chips)
Seat 4: e393edee (175,563 in chips)
Seat 5: 4ecba972 (190,151 in chips)
Seat 6: Hero (192,914 in chips)
Hero: posts the ante 1,000
4ecba972: posts the ante 1,000
a32338e3: posts the ante 1,000
e393edee: posts the ante 1,000
c7d35a50: posts the ante 1,000
4ecba972: posts small blind 3,500
Hero: posts big blind 7,000
*** HOLE CARDS ***
Dealt to c7d35a50 
Dealt to a32338e3 
Dealt to e393edee 
Dealt to 4ecba972 
Dealt to Hero [Ks 9c]
c7d35a50: folds
a32338e3: raises 7,000 to 14,000
e393edee: folds
4ecba972: folds
Hero: calls 7,000
*** FLOP *** [Js Th 8h]
Hero: checks
a32338e3: bets 14,000
Hero: raises 21,000 to 35,000
a32338e3: folds
Uncalled bet (21,000) returned to Hero
*** SHOWDOWN ***
Hero collected 64,500 from pot
*** SUMMARY ***
Total pot 64,500 | Rake 0 | Jackpot 0 | Bingo 0 | Fortune 0 | Tax 0
Board [Js Th 8h]
Seat 1: c7d35a50 folded before Flop
Seat 3: a32338e3 folded on the Flop
Seat 4: e393edee (button) folded before Flop
Seat 5: 4ecba972 (small blind) folded before Flop
Seat 6: Hero (big blind) won (64,500)


Poker Hand #TM4180368320: Tournament #187165250, Mini Hypersonic $2.50 Hold'em No Limit - Level26(3,500/7,000) - 2025/02/03 17:38:25
Table '72' 6-max Seat #1 is the button
Seat 1: c7d35a50 (115,747 in chips)
Seat 2: 59daca6 (47,368 in chips)
Seat 4: e393edee (125,195 in chips)
Seat 5: 4ecba972 (191,151 in chips)
Seat 6: Hero (193,914 in chips)
Hero: posts the ante 1,000
4ecba972: posts the ante 1,000
e393edee: posts the ante 1,000
59daca6: posts the ante 1,000
c7d35a50: posts the ante 1,000
59daca6: posts small blind 3,500
e393edee: posts big blind 7,000
*** HOLE CARDS ***
Dealt to c7d35a50 
Dealt to 59daca6 
Dealt to e393edee 
Dealt to 4ecba972 
Dealt to Hero [3s Ac]
4ecba972: folds
Hero: folds
c7d35a50: folds
59daca6: raises 39,368 to 46,368 and is all-in
e393edee: calls 39,368
59daca6: shows [8h Kh]
e393edee: shows [Ah 9c]
*** FLOP *** [Qd Ad As]
*** TURN *** [Qd Ad As] [6d]
*** RIVER *** [Qd Ad As 6d] [9s]
*** SHOWDOWN ***
e393edee collected 97,736 from pot
*** SUMMARY ***
Total pot 97,736 | Rake 0 | Jackpot 0 | Bingo 0 | Fortune 0 | Tax 0
Board [Qd Ad As 6d 9s]
Seat 1: c7d35a50 (button) folded before Flop
Seat 2: 59daca6 (small blind) showed [8h Kh] and lost with Pair of Aces
Seat 4: e393edee (big blind) showed [Ah 9c] and won (97,736) with Aces Full over Nines
Seat 5: 4ecba972 folded before Flop
Seat 6: Hero folded before Flop


Poker Hand #TM4180368289: Tournament #187165250, Mini Hypersonic $2.50 Hold'em No Limit - Level25(3,000/6,000) - 2025/02/03 17:36:57
Table '72' 6-max Seat #6 is the button
Seat 1: c7d35a50 (119,647 in chips)
Seat 2: 59daca6 (54,268 in chips)
Seat 3: 8495155d (65,272 in chips)
Seat 4: e393edee (126,095 in chips)
Seat 5: 4ecba972 (113,279 in chips)
Seat 6: Hero (194,814 in chips)
Hero: posts the ante 900
4ecba972: posts the ante 900
e393edee: posts the ante 900
8495155d: posts the ante 900
59daca6: posts the ante 900
c7d35a50: posts the ante 900
c7d35a50: posts small blind 3,000
59daca6: posts big blind 6,000
*** HOLE CARDS ***
Dealt to c7d35a50 
Dealt to 59daca6 
Dealt to 8495155d 
Dealt to e393edee 
Dealt to 4ecba972 
Dealt to Hero [Kh 7d]
8495155d: raises 6,000 to 12,000
e393edee: folds
4ecba972: calls 12,000
Hero: folds
c7d35a50: folds
59daca6: folds
*** FLOP *** [2d 2s 9d]
8495155d: bets 12,000
4ecba972: calls 12,000
*** TURN *** [2d 2s 9d] [Jc]
8495155d: bets 40,372 and is all-in
4ecba972: calls 40,372
8495155d: shows [Td Tc] (Pair of Tens and Pair of Twos)
4ecba972: shows [Jd Qh] (Pair of Jacks and Pair of Twos)
*** RIVER *** [2d 2s 9d Jc] [Kc]
*** SHOWDOWN ***
4ecba972 collected 143,144 from pot
*** SUMMARY ***
Total pot 143,144 | Rake 0 | Jackpot 0 | Bingo 0 | Fortune 0 | Tax 0
Board [2d 2s 9d Jc Kc]
Seat 1: c7d35a50 (small blind) folded before Flop
Seat 2: 59daca6 (big blind) folded before Flop
Seat 3: 8495155d showed [Td Tc] and lost with Pair of Tens and Pair of Twos
Seat 4: e393edee folded before Flop
Seat 5: 4ecba972 showed [Jd Qh] and won (143,144) with Pair of Jacks and Pair of Twos
Seat 6: Hero (button) folded before Flop


Poker Hand #TM4180368270: Tournament #187165250, Mini Hypersonic $2.50 Hold'em No Limit - Level25(3,000/6,000) - 2025/02/03 17:36:09
Table '72' 6-max Seat #5 is the button
Seat 1: c7d35a50 (126,547 in chips)
Seat 2: 59daca6 (55,168 in chips)
Seat 3: 8495155d (66,172 in chips)
Seat 4: e393edee (126,995 in chips)
Seat 5: 4ecba972 (129,179 in chips)
Seat 6: Hero (169,314 in chips)
Hero: posts the ante 900
4ecba972: posts the ante 900
e393edee: posts the ante 900
8495155d: posts the ante 900
59daca6: posts the ante 900
c7d35a50: posts the ante 900
Hero: posts small blind 3,000
c7d35a50: posts big blind 6,000
*** HOLE CARDS ***
Dealt to c7d35a50 
Dealt to 59daca6 
Dealt to 8495155d 
Dealt to e393edee 
Dealt to 4ecba972 
Dealt to Hero [Jc Jd]
59daca6: folds
8495155d: folds
e393edee: folds
4ecba972: raises 9,000 to 15,000
Hero: raises 21,000 to 36,000
c7d35a50: folds
4ecba972: folds
Uncalled bet (21,000) returned to Hero
*** SHOWDOWN ***
Hero collected 41,400 from pot
*** SUMMARY ***
Total pot 41,400 | Rake 0 | Jackpot 0 | Bingo 0 | Fortune 0 | Tax 0
Seat 1: c7d35a50 (big blind) folded before Flop
Seat 2: 59daca6 folded before Flop
Seat 3: 8495155d folded before Flop
Seat 4: e393edee folded before Flop
Seat 5: 4ecba972 (button) folded before Flop
Seat 6: Hero (small blind) collected (41,400)


Poker Hand #TM4180368256: Tournament #187165250, Mini Hypersonic $2.50 Hold'em No Limit - Level25(3,000/6,000) - 2025/02/03 17:35:38
Table '72' 6-max Seat #4 is the button
Seat 1: c7d35a50 (127,447 in chips)
Seat 2: 59daca6 (56,068 in chips)
Seat 3: 8495155d (67,072 in chips)
Seat 4: e393edee (127,895 in chips)
Seat 5: 4ecba972 (133,079 in chips)
Seat 6: Hero (161,814 in chips)
Hero: posts the ante 900
4ecba972: posts the ante 900
e393edee: posts the ante 900
8495155d: posts the ante 900
59daca6: posts the ante 900
c7d35a50: posts the ante 900
4ecba972: posts small blind 3,000
Hero: posts big blind 6,000
*** HOLE CARDS ***
Dealt to c7d35a50 
Dealt to 59daca6 
Dealt to 8495155d 
Dealt to e393edee 
Dealt to 4ecba972 
Dealt to Hero [Jh 2s]
c7d35a50: folds
59daca6: folds
8495155d: folds
e393edee: folds
4ecba972: folds
Uncalled bet (3,000) returned to Hero
*** SHOWDOWN ***
Hero collected 11,400 from pot
*** SUMMARY ***
Total pot 11,400 | Rake 0 | Jackpot 0 | Bingo 0 | Fortune 0 | Tax 0
Seat 1: c7d35a50 folded before Flop
Seat 2: 59daca6 folded before Flop
Seat 3: 8495155d folded before Flop
Seat 4: e393edee (button) folded before Flop
Seat 5: 4ecba972 (small blind) folded before Flop
Seat 6: Hero (big blind) collected (11,400)


Poker Hand #TM4180368235: Tournament #187165250, Mini Hypersonic $2.50 Hold'em No Limit - Level25(3,000/6,000) - 2025/02/03 17:34:25
Table '72' 6-max Seat #3 is the button
Seat 1: c7d35a50 (122,647 in chips)
Seat 2: 59daca6 (56,968 in chips)
Seat 3: 8495155d (67,972 in chips)
Seat 4: e393edee (123,095 in chips)
Seat 5: 4ecba972 (139,979 in chips)
Seat 6: Hero (162,714 in chips)
Hero: posts the ante 900
4ecba972: posts the ante 900
e393edee: posts the ante 900
8495155d: posts the ante 900
59daca6: posts the ante 900
c7d35a50: posts the ante 900
e393edee: posts small blind 3,000
4ecba972: posts big blind 6,000
*** HOLE CARDS ***
Dealt to c7d35a50 
Dealt to 59daca6 
Dealt to 8495155d 
Dealt to e393edee 
Dealt to 4ecba972 
Dealt to Hero [4c 3c]
Hero: folds
c7d35a50: raises 6,000 to 12,000
59daca6: folds
8495155d: folds
e393edee: calls 9,000
4ecba972: folds
*** FLOP *** [Qd Jc 8c]
e393edee: checks
c7d35a50: checks
*** TURN *** [Qd Jc 8c] [Qh]
e393edee: checks
c7d35a50: checks
*** RIVER *** [Qd Jc 8c Qh] [Jd]
e393edee: checks
c7d35a50: checks
e393edee: shows [Ah Td] (Pair of Queens and Pair of Jacks)
c7d35a50: shows [Ac 4s] (Pair of Queens and Pair of Jacks)
*** SHOWDOWN ***
c7d35a50 collected 17,700 from pot
e393edee collected 17,700 from pot
*** SUMMARY ***
Total pot 35,400 | Rake 0 | Jackpot 0 | Bingo 0 | Fortune 0 | Tax 0
Board [Qd Jc 8c Qh Jd]
Seat 1: c7d35a50 showed [Ac 4s] and won (17,700) with Pair of Queens and Pair of Jacks
Seat 2: 59daca6 folded before Flop
Seat 3: 8495155d (button) folded before Flop
Seat 4: e393edee (small blind) showed [Ah Td] and won (17,700) with Pair of Queens and Pair of Jacks
Seat 5: 4ecba972 (big blind) folded before Flop
Seat 6: Hero folded before Flop


Poker Hand #TM4180368215: Tournament #187165250, Mini Hypersonic $2.50 Hold'em No Limit - Level24(2,500/5,000) - 2025/02/03 17:33:23
Table '72' 6-max Seat #2 is the button
Seat 1: c7d35a50 (133,397 in chips)
Seat 2: 59daca6 (57,718 in chips)
Seat 3: 8495155d (71,222 in chips)
Seat 4: e393edee (97,595 in chips)
Seat 6: Hero (173,464 in chips)
Hero: posts the ante 750
e393edee: posts the ante 750
59daca6: posts the ante 750
8495155d: posts the ante 750
c7d35a50: posts the ante 750
8495155d: posts small blind 2,500
e393edee: posts big blind 5,000
*** HOLE CARDS ***
Dealt to c7d35a50 
Dealt to 59daca6 
Dealt to 8495155d 
Dealt to e393edee 
Dealt to Hero [Kh Qd]
Hero: raises 5,000 to 10,000
c7d35a50: calls 10,000
59daca6: folds
8495155d: folds
e393edee: raises 86,845 to 96,845 and is all-in
Hero: folds
c7d35a50: folds
Uncalled bet (86,845) returned to e393edee
*** SHOWDOWN ***
e393edee collected 36,250 from pot
*** SUMMARY ***
Total pot 36,250 | Rake 0 | Jackpot 0 | Bingo 0 | Fortune 0 | Tax 0
Seat 1: c7d35a50 folded before Flop
Seat 2: 59daca6 (button) folded before Flop
Seat 3: 8495155d (small blind) folded before Flop
Seat 4: e393edee (big blind) collected (36,250)
Seat 6: Hero folded before Flop


Poker Hand #TM4180368208: Tournament #187165250, Mini Hypersonic $2.50 Hold'em No Limit - Level24(2,500/5,000) - 2025/02/03 17:33:07
Table '72' 6-max Seat #1 is the button
Seat 1: c7d35a50 (134,147 in chips)
Seat 2: 59daca6 (60,968 in chips)
Seat 3: 8495155d (65,722 in chips)
Seat 4: e393edee (98,345 in chips)
Seat 6: Hero (174,214 in chips)
Hero: posts the ante 750
e393edee: posts the ante 750
8495155d: posts the ante 750
59daca6: posts the ante 750
c7d35a50: posts the ante 750
59daca6: posts small blind 2,500
8495155d: posts big blind 5,000
*** HOLE CARDS ***
Dealt to c7d35a50 
Dealt to 59daca6 
Dealt to 8495155d 
Dealt to e393edee 
Dealt to Hero [Ts 2c]
e393edee: folds
Hero: folds
c7d35a50: folds
59daca6: folds
Uncalled bet (2,500) returned to 8495155d
*** SHOWDOWN ***
8495155d collected 8,750 from pot
*** SUMMARY ***
Total pot 8,750 | Rake 0 | Jackpot 0 | Bingo 0 | Fortune 0 | Tax 0
Seat 1: c7d35a50 (button) folded before Flop
Seat 2: 59daca6 (small blind) folded before Flop
Seat 3: 8495155d (big blind) collected (8,750)
Seat 4: e393edee folded before Flop
Seat 6: Hero folded before Flop


Poker Hand #TM4180368193: Tournament #187165250, Mini Hypersonic $2.50 Hold'em No Limit - Level24(2,500/5,000) - 2025/02/03 17:32:39
Table '72' 6-max Seat #6 is the button
Seat 1: c7d35a50 (137,397 in chips)
Seat 2: 59daca6 (66,718 in chips)
Seat 3: 8495155d (66,472 in chips)
Seat 4: e393edee (87,845 in chips)
Seat 6: Hero (174,964 in chips)
Hero: posts the ante 750
e393edee: posts the ante 750
8495155d: posts the ante 750
59daca6: posts the ante 750
c7d35a50: posts the ante 750
c7d35a50: posts small blind 2,500
59daca6: posts big blind 5,000
*** HOLE CARDS ***
Dealt to c7d35a50 
Dealt to 59daca6 
Dealt to 8495155d 
Dealt to e393edee 
Dealt to Hero [3h Qc]
8495155d: folds
e393edee: raises 10,000 to 15,000
Hero: folds
c7d35a50: folds
59daca6: folds
Uncalled bet (10,000) returned to e393edee
*** SHOWDOWN ***
e393edee collected 16,250 from pot
*** SUMMARY ***
Total pot 16,250 | Rake 0 | Jackpot 0 | Bingo 0 | Fortune 0 | Tax 0
Seat 1: c7d35a50 (small blind) folded before Flop
Seat 2: 59daca6 (big blind) folded before Flop
Seat 3: 8495155d folded before Flop
Seat 4: e393edee collected (16,250)
Seat 6: Hero (button) folded before Flop


Poker Hand #TM4180368176: Tournament #187165250, Mini Hypersonic $2.50 Hold'em No Limit - Level24(2,500/5,000) - 2025/02/03 17:31:55
Table '72' 6-max Seat #4 is the button
Seat 1: c7d35a50 (95,565 in chips)
Seat 2: 59daca6 (67,468 in chips)
Seat 3: 8495155d (67,222 in chips)
Seat 4: e393edee (88,595 in chips)
Seat 5: 8beda988 (33,832 in chips)
Seat 6: Hero (180,714 in chips)
Hero: posts the ante 750
e393edee: posts the ante 750
8beda988: posts the ante 750
8495155d: posts the ante 750
59daca6: posts the ante 750
c7d35a50: posts the ante 750
8beda988: posts small blind 2,500
Hero: posts big blind 5,000
*** HOLE CARDS ***
Dealt to c7d35a50 
Dealt to 59daca6 
Dealt to 8495155d 
Dealt to e393edee 
Dealt to 8beda988 
Dealt to Hero [Jh Kc]
c7d35a50: raises 5,000 to 10,000
59daca6: folds
8495155d: folds
e393edee: folds
8beda988: raises 23,082 to 33,082 and is all-in
Hero: folds
c7d35a50: calls 23,082
8beda988: shows [5d 5h]
c7d35a50: shows [Ah Th]
*** FLOP *** [Tc 9c 7c]
*** TURN *** [Tc 9c 7c] [7d]
*** RIVER *** [Tc 9c 7c 7d] [Td]
*** SHOWDOWN ***
c7d35a50 collected 75,664 from pot
*** SUMMARY ***
Total pot 75,664 | Rake 0 | Jackpot 0 | Bingo 0 | Fortune 0 | Tax 0
Board [Tc 9c 7c 7d Td]
Seat 1: c7d35a50 showed [Ah Th] and won (75,664) with Tens Full over Sevens
Seat 2: 59daca6 folded before Flop
Seat 3: 8495155d folded before Flop
Seat 4: e393edee (button) folded before Flop
Seat 5: 8beda988 (small blind) showed [5d 5h] and lost with Pair of Tens and Pair of Sevens
Seat 6: Hero (big blind) folded before Flop


Poker Hand #TM4180368159: Tournament #187165250, Mini Hypersonic $2.50 Hold'em No Limit - Level24(2,500/5,000) - 2025/02/03 17:31:20
Table '72' 6-max Seat #2 is the button
Seat 1: c7d35a50 (96,315 in chips)
Seat 2: 59daca6 (68,218 in chips)
Seat 4: e393edee (91,845 in chips)
Seat 5: 8beda988 (28,332 in chips)
Seat 6: Hero (181,464 in chips)
Hero: posts the ante 750
8beda988: posts the ante 750
e393edee: posts the ante 750
59daca6: posts the ante 750
c7d35a50: posts the ante 750
e393edee: posts small blind 2,500
8beda988: posts big blind 5,000
*** HOLE CARDS ***
Dealt to c7d35a50 
Dealt to 59daca6 
Dealt to e393edee 
Dealt to 8beda988 
Dealt to Hero [7c 6s]
Hero: folds
c7d35a50: folds
59daca6: folds
e393edee: folds
Uncalled bet (2,500) returned to 8beda988
*** SHOWDOWN ***
8beda988 collected 8,750 from pot
*** SUMMARY ***
Total pot 8,750 | Rake 0 | Jackpot 0 | Bingo 0 | Fortune 0 | Tax 0
Seat 1: c7d35a50 folded before Flop
Seat 2: 59daca6 (button) folded before Flop
Seat 4: e393edee (small blind) folded before Flop
Seat 5: 8beda988 (big blind) collected (8,750)
Seat 6: Hero folded before Flop


Poker Hand #TM4180368149: Tournament #187165250, Mini Hypersonic $2.50 Hold'em No Limit - Level24(2,500/5,000) - 2025/02/03 17:30:52
Table '72' 6-max Seat #1 is the button
Seat 1: c7d35a50 (97,065 in chips)
Seat 2: 59daca6 (71,468 in chips)
Seat 4: e393edee (97,595 in chips)
Seat 5: 8beda988 (29,082 in chips)
Seat 6: Hero (170,964 in chips)
Hero: posts the ante 750
8beda988: posts the ante 750
e393edee: posts the ante 750
59daca6: posts the ante 750
c7d35a50: posts the ante 750
59daca6: posts small blind 2,500
e393edee: posts big blind 5,000
*** HOLE CARDS ***
Dealt to c7d35a50 
Dealt to 59daca6 
Dealt to e393edee 
Dealt to 8beda988 
Dealt to Hero [Ad Jc]
8beda988: folds
Hero: raises 5,000 to 10,000
c7d35a50: folds
59daca6: folds
e393edee: folds
Uncalled bet (5,000) returned to Hero
*** SHOWDOWN ***
Hero collected 16,250 from pot
*** SUMMARY ***
Total pot 16,250 | Rake 0 | Jackpot 0 | Bingo 0 | Fortune 0 | Tax 0
Seat 1: c7d35a50 (button) folded before Flop
Seat 2: 59daca6 (small blind) folded before Flop
Seat 4: e393edee (big blind) folded before Flop
Seat 5: 8beda988 folded before Flop
Seat 6: Hero collected (16,250)


Poker Hand #TM4180368126: Tournament #187165250, Mini Hypersonic $2.50 Hold'em No Limit - Level24(2,500/5,000) - 2025/02/03 17:29:57
Table '72' 6-max Seat #6 is the button
Seat 1: c7d35a50 (40,650 in chips)
Seat 2: 59daca6 (112,118 in chips)
Seat 3: 54067a76 (29,181 in chips)
Seat 4: e393edee (98,345 in chips)
Seat 5: 8beda988 (14,166 in chips)
Seat 6: Hero (171,714 in chips)
Hero: posts the ante 750
54067a76: posts the ante 750
8beda988: posts the ante 750
e393edee: posts the ante 750
59daca6: posts the ante 750
c7d35a50: posts the ante 750
c7d35a50: posts small blind 2,500
59daca6: posts big blind 5,000
*** HOLE CARDS ***
Dealt to c7d35a50 
Dealt to 59daca6 
Dealt to 54067a76 
Dealt to e393edee 
Dealt to 8beda988 
Dealt to Hero [Kc 6d]
54067a76: raises 17,500 to 22,500
e393edee: folds
8beda988: calls 13,416 and is all-in
Hero: folds
c7d35a50: raises 17,400 to 39,900 and is all-in
59daca6: calls 34,900
54067a76: calls 5,931 and is all-in
c7d35a50: shows [Qh Ah]
59daca6: shows [Td Th]
54067a76: shows [9d 9s]
8beda988: shows [Qs Jh]
*** FLOP *** [4d 6s 4s]
*** TURN *** [4d 6s 4s] [4c]
*** RIVER *** [4d 6s 4s 4c] [Qd]
*** SHOWDOWN ***
8beda988 collected 29,082 from pot
c7d35a50 collected 29,082 from pot
c7d35a50 collected 45,045 from pot
c7d35a50 collected 22,938 from pot
*** SUMMARY ***
Total pot 126,147 | Rake 0 | Jackpot 0 | Bingo 0 | Fortune 0 | Tax 0
Board [4d 6s 4s 4c Qd]
Seat 1: c7d35a50 (small blind) showed [Qh Ah] and won (97,065) with Fours Full over Queens
Seat 2: 59daca6 (big blind) showed [Td Th] and lost with Fours Full over Tens
Seat 3: 54067a76 showed [9d 9s] and lost with Fours Full over Nines
Seat 4: e393edee folded before Flop
Seat 5: 8beda988 showed [Qs Jh] and won (29,082) with Fours Full over Queens
Seat 6: Hero (button) folded before Flop


Poker Hand #TM4180368114: Tournament #187165250, Mini Hypersonic $2.50 Hold'em No Limit - Level23(2,000/4,000) - 2025/02/03 17:29:23
Table '72' 6-max Seat #5 is the button
Seat 1: c7d35a50 (45,250 in chips)
Seat 2: 59daca6 (112,718 in chips)
Seat 3: 54067a76 (29,781 in chips)
Seat 4: e393edee (89,345 in chips)
Seat 5: 8beda988 (14,766 in chips)
Seat 6: Hero (174,314 in chips)
Hero: posts the ante 600
54067a76: posts the ante 600
8beda988: posts the ante 600
e393edee: posts the ante 600
59daca6: posts the ante 600
c7d35a50: posts the ante 600
Hero: posts small blind 2,000
c7d35a50: posts big blind 4,000
*** HOLE CARDS ***
Dealt to c7d35a50 
Dealt to 59daca6 
Dealt to 54067a76 
Dealt to e393edee 
Dealt to 8beda988 
Dealt to Hero [Th 5c]
59daca6: folds
54067a76: folds
e393edee: raises 8,000 to 12,000
8beda988: folds
Hero: folds
c7d35a50: folds
Uncalled bet (8,000) returned to e393edee
*** SHOWDOWN ***
e393edee collected 13,600 from pot
*** SUMMARY ***
Total pot 13,600 | Rake 0 | Jackpot 0 | Bingo 0 | Fortune 0 | Tax 0
Seat 1: c7d35a50 (big blind) folded before Flop
Seat 2: 59daca6 folded before Flop
Seat 3: 54067a76 folded before Flop
Seat 4: e393edee collected (13,600)
Seat 5: 8beda988 (button) folded before Flop
Seat 6: Hero (small blind) folded before Flop


Poker Hand #TM4180368079: Tournament #187165250, Mini Hypersonic $2.50 Hold'em No Limit - Level23(2,000/4,000) - 2025/02/03 17:27:59
Table '72' 6-max Seat #4 is the button
Seat 1: c7d35a50 (45,850 in chips)
Seat 2: 59daca6 (128,446 in chips)
Seat 3: 54067a76 (30,381 in chips)
Seat 4: e393edee (89,945 in chips)
Seat 5: 8beda988 (17,366 in chips)
Seat 6: Hero (154,186 in chips)
Hero: posts the ante 600
54067a76: posts the ante 600
e393edee: posts the ante 600
8beda988: posts the ante 600
59daca6: posts the ante 600
c7d35a50: posts the ante 600
8beda988: posts small blind 2,000
Hero: posts big blind 4,000
*** HOLE CARDS ***
Dealt to c7d35a50 
Dealt to 59daca6 
Dealt to 54067a76 
Dealt to e393edee 
Dealt to 8beda988 
Dealt to Hero [Qs Jd]
c7d35a50: folds
59daca6: raises 4,000 to 8,000
54067a76: folds
e393edee: folds
8beda988: folds
Hero: calls 4,000
*** FLOP *** [Kc Jc 2h]
Hero: checks
59daca6: checks
*** TURN *** [Kc Jc 2h] [7s]
Hero: checks
59daca6: bets 7,128
Hero: raises 8,872 to 16,000
59daca6: folds
Uncalled bet (8,872) returned to Hero
*** SHOWDOWN ***
Hero collected 35,856 from pot
*** SUMMARY ***
Total pot 35,856 | Rake 0 | Jackpot 0 | Bingo 0 | Fortune 0 | Tax 0
Board [Kc Jc 2h 7s]
Seat 1: c7d35a50 folded before Flop
Seat 2: 59daca6 folded on the Turn
Seat 3: 54067a76 folded before Flop
Seat 4: e393edee (button) folded before Flop
Seat 5: 8beda988 (small blind) folded before Flop
Seat 6: Hero (big blind) won (35,856)


Poker Hand #TM4180991759: Tournament #187165250, Mini Hypersonic $2.50 Hold'em No Limit - Level23(2,000/4,000) - 2025/02/03 17:26:55
Table '16' 6-max Seat #1 is the button
Seat 1: 98230d7b (72,478 in chips)
Seat 3: a3dbf391 (127,400 in chips)
Seat 4: Hero (109,631 in chips)
Seat 5: bd01d0e (40,755 in chips)
Seat 6: d06b3360 (90,446 in chips)
Hero: posts the ante 600
bd01d0e: posts the ante 600
d06b3360: posts the ante 600
98230d7b: posts the ante 600
a3dbf391: posts the ante 600
a3dbf391: posts small blind 2,000
Hero: posts big blind 4,000
*** HOLE CARDS ***
Dealt to 98230d7b 
Dealt to a3dbf391 
Dealt to Hero [Qc Ad]
Dealt to bd01d0e 
Dealt to d06b3360 
bd01d0e: raises 8,000 to 12,000
d06b3360: folds
98230d7b: folds
a3dbf391: folds
Hero: raises 56,000 to 68,000
bd01d0e: calls 28,155 and is all-in
Uncalled bet (27,845) returned to Hero
Hero: shows [Qc Ad]
bd01d0e: shows [Td Th]
*** FLOP *** [5d 8s 2h]
*** TURN *** [5d 8s 2h] [Qs]
*** RIVER *** [5d 8s 2h Qs] [9s]
98230d7b: shows [5h 5s] (Three Fives)
*** SHOWDOWN ***
Hero collected 85,310 from pot
*** SUMMARY ***
Total pot 85,310 | Rake 0 | Jackpot 0 | Bingo 0 | Fortune 0 | Tax 0
Board [5d 8s 2h Qs 9s]
Seat 1: 98230d7b (button) folded before Flop
Seat 3: a3dbf391 (small blind) folded before Flop
Seat 4: Hero (big blind) showed [Qc Ad] and won (85,310) with Pair of Queens
Seat 5: bd01d0e showed [Td Th] and lost with Pair of Tens
Seat 6: d06b3360 folded before Flop


Poker Hand #TM4180991734: Tournament #187165250, Mini Hypersonic $2.50 Hold'em No Limit - Level23(2,000/4,000) - 2025/02/03 17:25:40
Table '16' 6-max Seat #6 is the button
Seat 1: 98230d7b (75,078 in chips)
Seat 2: 39567645 (36,521 in chips)
Seat 3: a3dbf391 (128,000 in chips)
Seat 4: Hero (110,231 in chips)
Seat 5: bd01d0e (41,355 in chips)
Seat 6: d06b3360 (49,525 in chips)
Hero: posts the ante 600
bd01d0e: posts the ante 600
d06b3360: posts the ante 600
a3dbf391: posts the ante 600
98230d7b: posts the ante 600
39567645: posts the ante 600
98230d7b: posts small blind 2,000
39567645: posts big blind 4,000
*** HOLE CARDS ***
Dealt to 98230d7b 
Dealt to 39567645 
Dealt to a3dbf391 
Dealt to Hero [7d 8h]
Dealt to bd01d0e 
Dealt to d06b3360 
a3dbf391: folds
Hero: folds
bd01d0e: folds
d06b3360: raises 4,000 to 8,000
98230d7b: folds
39567645: calls 4,000
*** FLOP *** [4d Qd 6s]
39567645: checks
d06b3360: bets 4,000
39567645: raises 23,921 to 27,921 and is all-in
d06b3360: calls 23,921
39567645: shows [4h 3h] (Pair of Fours)
d06b3360: shows [Kc 6c] (Pair of Sixes)
*** TURN *** [4d Qd 6s] [7c]
*** RIVER *** [4d Qd 6s 7c] [As]
*** SHOWDOWN ***
d06b3360 collected 77,442 from pot
*** SUMMARY ***
Total pot 77,442 | Rake 0 | Jackpot 0 | Bingo 0 | Fortune 0 | Tax 0
Board [4d Qd 6s 7c As]
Seat 1: 98230d7b (small blind) folded before Flop
Seat 2: 39567645 (big blind) showed [4h 3h] and lost with Pair of Fours
Seat 3: a3dbf391 folded before Flop
Seat 4: Hero folded before Flop
Seat 5: bd01d0e folded before Flop
Seat 6: d06b3360 (button) showed [Kc 6c] and won (77,442) with Pair of Sixes


Poker Hand #TM4180991695: Tournament #187165250, Mini Hypersonic $2.50 Hold'em No Limit - Level22(1,750/3,500) - 2025/02/03 17:24:01
Table '16' 6-max Seat #5 is the button
Seat 1: 98230d7b (63,828 in chips)
Seat 2: 39567645 (37,021 in chips)
Seat 3: a3dbf391 (128,500 in chips)
Seat 4: Hero (110,731 in chips)
Seat 5: bd01d0e (48,855 in chips)
Seat 6: d06b3360 (51,775 in chips)
Hero: posts the ante 500
bd01d0e: posts the ante 500
d06b3360: posts the ante 500
a3dbf391: posts the ante 500
98230d7b: posts the ante 500
39567645: posts the ante 500
d06b3360: posts small blind 1,750
98230d7b: posts big blind 3,500
*** HOLE CARDS ***
Dealt to 98230d7b 
Dealt to 39567645 
Dealt to a3dbf391 
Dealt to Hero [Jc 6d]
Dealt to bd01d0e 
Dealt to d06b3360 
39567645: folds
a3dbf391: folds
Hero: folds
bd01d0e: raises 3,500 to 7,000
d06b3360: folds
98230d7b: raises 18,750 to 25,750
bd01d0e: folds
Uncalled bet (18,750) returned to 98230d7b
*** SHOWDOWN ***
98230d7b collected 18,750 from pot
*** SUMMARY ***
Total pot 18,750 | Rake 0 | Jackpot 0 | Bingo 0 | Fortune 0 | Tax 0
Seat 1: 98230d7b (big blind) collected (18,750)
Seat 2: 39567645 folded before Flop
Seat 3: a3dbf391 folded before Flop
Seat 4: Hero folded before Flop
Seat 5: bd01d0e (button) folded before Flop
Seat 6: d06b3360 (small blind) folded before Flop


Poker Hand #TM4180991652: Tournament #187165250, Mini Hypersonic $2.50 Hold'em No Limit - Level22(1,750/3,500) - 2025/02/03 17:22:02
Table '16' 6-max Seat #4 is the button
Seat 1: 98230d7b (64,328 in chips)
Seat 2: 39567645 (37,521 in chips)
Seat 3: a3dbf391 (129,000 in chips)
Seat 4: Hero (102,981 in chips)
Seat 5: bd01d0e (51,105 in chips)
Seat 6: d06b3360 (55,775 in chips)
Hero: posts the ante 500
bd01d0e: posts the ante 500
d06b3360: posts the ante 500
a3dbf391: posts the ante 500
98230d7b: posts the ante 500
39567645: posts the ante 500
bd01d0e: posts small blind 1,750
d06b3360: posts big blind 3,500
*** HOLE CARDS ***
Dealt to 98230d7b 
Dealt to 39567645 
Dealt to a3dbf391 
Dealt to Hero [6s 6h]
Dealt to bd01d0e 
Dealt to d06b3360 
98230d7b: folds
39567645: folds
a3dbf391: folds
Hero: raises 98,981 to 102,481 and is all-in
bd01d0e: folds
d06b3360: folds
Uncalled bet (98,981) returned to Hero
*** SHOWDOWN ***
Hero collected 11,750 from pot
*** SUMMARY ***
Total pot 11,750 | Rake 0 | Jackpot 0 | Bingo 0 | Fortune 0 | Tax 0
Seat 1: 98230d7b folded before Flop
Seat 2: 39567645 folded before Flop
Seat 3: a3dbf391 folded before Flop
Seat 4: Hero (button) collected (11,750)
Seat 5: bd01d0e (small blind) folded before Flop
Seat 6: d06b3360 (big blind) folded before Flop


Poker Hand #TM4180991632: Tournament #187165250, Mini Hypersonic $2.50 Hold'em No Limit - Level21(1,500/3,000) - 2025/02/03 17:21:05
Table '16' 6-max Seat #3 is the button
Seat 1: 98230d7b (64,778 in chips)
Seat 2: 39567645 (37,971 in chips)
Seat 3: a3dbf391 (111,909 in chips)
Seat 4: Hero (115,272 in chips)
Seat 5: bd01d0e (54,555 in chips)
Seat 6: d06b3360 (56,225 in chips)
Hero: posts the ante 450
bd01d0e: posts the ante 450
d06b3360: posts the ante 450
a3dbf391: posts the ante 450
98230d7b: posts the ante 450
39567645: posts the ante 450
Hero: posts small blind 1,500
bd01d0e: posts big blind 3,000
*** HOLE CARDS ***
Dealt to 98230d7b 
Dealt to 39567645 
Dealt to a3dbf391 
Dealt to Hero [5s 5c]
Dealt to bd01d0e 
Dealt to d06b3360 
d06b3360: folds
98230d7b: folds
39567645: folds
a3dbf391: raises 3,000 to 6,000
Hero: calls 4,500
bd01d0e: folds
*** FLOP *** [2s Qh 2h]
Hero: checks
a3dbf391: checks
*** TURN *** [2s Qh 2h] [8h]
Hero: checks
a3dbf391: bets 5,841
Hero: calls 5,841
*** RIVER *** [2s Qh 2h 8h] [7s]
Hero: checks
a3dbf391: checks
Hero: shows [5s 5c] (Pair of Fives and Pair of Twos)
a3dbf391: shows [6h 6c] (Pair of Sixes and Pair of Twos)
*** SHOWDOWN ***
a3dbf391 collected 29,382 from pot
*** SUMMARY ***
Total pot 29,382 | Rake 0 | Jackpot 0 | Bingo 0 | Fortune 0 | Tax 0
Board [2s Qh 2h 8h 7s]
Seat 1: 98230d7b folded before Flop
Seat 2: 39567645 folded before Flop
Seat 3: a3dbf391 (button) showed [6h 6c] and won (29,382) with Pair of Sixes and Pair of Twos
Seat 4: Hero (small blind) showed [5s 5c] and lost with Pair of Fives and Pair of Twos
Seat 5: bd01d0e (big blind) folded before Flop
Seat 6: d06b3360 folded before Flop


Poker Hand #TM4180991611: Tournament #187165250, Mini Hypersonic $2.50 Hold'em No Limit - Level21(1,500/3,000) - 2025/02/03 17:20:17
Table '16' 6-max Seat #2 is the button
Seat 1: 98230d7b (65,228 in chips)
Seat 2: 39567645 (38,421 in chips)
Seat 3: a3dbf391 (94,818 in chips)
Seat 4: Hero (118,722 in chips)
Seat 5: bd01d0e (55,005 in chips)
Seat 6: d06b3360 (68,516 in chips)
Hero: posts the ante 450
bd01d0e: posts the ante 450
d06b3360: posts the ante 450
98230d7b: posts the ante 450
a3dbf391: posts the ante 450
39567645: posts the ante 450
a3dbf391: posts small blind 1,500
Hero: posts big blind 3,000
*** HOLE CARDS ***
Dealt to 98230d7b 
Dealt to 39567645 
Dealt to a3dbf391 
Dealt to Hero [2d Qs]
Dealt to bd01d0e 
Dealt to d06b3360 
bd01d0e: folds
d06b3360: raises 3,000 to 6,000
98230d7b: folds
39567645: folds
a3dbf391: calls 4,500
Hero: folds
*** FLOP *** [Kc 9h 2s]
a3dbf391: bets 5,841
d06b3360: calls 5,841
*** TURN *** [Kc 9h 2s] [4s]
a3dbf391: bets 9,697
d06b3360: folds
Uncalled bet (9,697) returned to a3dbf391
*** SHOWDOWN ***
a3dbf391 collected 29,382 from pot
*** SUMMARY ***
Total pot 29,382 | Rake 0 | Jackpot 0 | Bingo 0 | Fortune 0 | Tax 0
Board [Kc 9h 2s 4s]
Seat 1: 98230d7b folded before Flop
Seat 2: 39567645 (button) folded before Flop
Seat 3: a3dbf391 (small blind) won (29,382)
Seat 4: Hero (big blind) folded before Flop
Seat 5: bd01d0e folded before Flop
Seat 6: d06b3360 folded on the Turn


Poker Hand #TM4180991606: Tournament #187165250, Mini Hypersonic $2.50 Hold'em No Limit - Level21(1,500/3,000) - 2025/02/03 17:19:53
Table '16' 6-max Seat #1 is the button
Seat 1: 98230d7b (65,678 in chips)
Seat 2: 39567645 (40,371 in chips)
Seat 3: a3dbf391 (91,068 in chips)
Seat 4: Hero (119,172 in chips)
Seat 5: bd01d0e (55,455 in chips)
Seat 6: d06b3360 (68,966 in chips)
Hero: posts the ante 450
bd01d0e: posts the ante 450
d06b3360: posts the ante 450
98230d7b: posts the ante 450
a3dbf391: posts the ante 450
39567645: posts the ante 450
39567645: posts small blind 1,500
a3dbf391: posts big blind 3,000
*** HOLE CARDS ***
Dealt to 98230d7b 
Dealt to 39567645 
Dealt to a3dbf391 
Dealt to Hero [7c Kh]
Dealt to bd01d0e 
Dealt to d06b3360 
Hero: folds
bd01d0e: folds
d06b3360: folds
98230d7b: folds
39567645: folds
Uncalled bet (1,500) returned to a3dbf391
*** SHOWDOWN ***
a3dbf391 collected 5,700 from pot
*** SUMMARY ***
Total pot 5,700 | Rake 0 | Jackpot 0 | Bingo 0 | Fortune 0 | Tax 0
Seat 1: 98230d7b (button) folded before Flop
Seat 2: 39567645 (small blind) folded before Flop
Seat 3: a3dbf391 (big blind) collected (5,700)
Seat 4: Hero folded before Flop
Seat 5: bd01d0e folded before Flop
Seat 6: d06b3360 folded before Flop


Poker Hand #TM4180991568: Tournament #187165250, Mini Hypersonic $2.50 Hold'em No Limit - Level21(1,500/3,000) - 2025/02/03 17:18:24
Table '16' 6-max Seat #6 is the button
Seat 1: 98230d7b (67,628 in chips)
Seat 2: 39567645 (46,821 in chips)
Seat 3: a3dbf391 (91,518 in chips)
Seat 4: Hero (108,522 in chips)
Seat 5: bd01d0e (44,805 in chips)
Seat 6: d06b3360 (81,416 in chips)
Hero: posts the ante 450
bd01d0e: posts the ante 450
d06b3360: posts the ante 450
a3dbf391: posts the ante 450
98230d7b: posts the ante 450
39567645: posts the ante 450
98230d7b: posts small blind 1,500
39567645: posts big blind 3,000
*** HOLE CARDS ***
Dealt to 98230d7b 
Dealt to 39567645 
Dealt to a3dbf391 
Dealt to Hero [Jh Qc]
Dealt to bd01d0e 
Dealt to d06b3360 
a3dbf391: folds
Hero: raises 3,000 to 6,000
bd01d0e: calls 6,000
d06b3360: calls 6,000
98230d7b: folds
39567645: calls 3,000
*** FLOP *** [3h Qs 6c]
39567645: checks
Hero: bets 6,000
bd01d0e: calls 6,000
d06b3360: calls 6,000
39567645: folds
*** TURN *** [3h Qs 6c] [3s]
Hero: checks
bd01d0e: checks
d06b3360: checks
*** RIVER *** [3h Qs 6c 3s] [Ks]
Hero: checks
bd01d0e: checks
d06b3360: checks
Hero: shows [Jh Qc] (Pair of Queens and Pair of Treys)
bd01d0e: shows [Qd 9d] (Pair of Queens and Pair of Treys)
d06b3360: shows [6d 5d] (Pair of Sixes and Pair of Treys)
*** SHOWDOWN ***
Hero collected 23,100 from pot
bd01d0e collected 23,100 from pot
*** SUMMARY ***
Total pot 46,200 | Rake 0 | Jackpot 0 | Bingo 0 | Fortune 0 | Tax 0
Board [3h Qs 6c 3s Ks]
Seat 1: 98230d7b (small blind) folded before Flop
Seat 2: 39567645 (big blind) folded on the Flop
Seat 3: a3dbf391 folded before Flop
Seat 4: Hero showed [Jh Qc] and won (23,100) with Pair of Queens and Pair of Treys
Seat 5: bd01d0e showed [Qd 9d] and won (23,100) with Pair of Queens and Pair of Treys
Seat 6: d06b3360 (button) showed [6d 5d] and lost with Pair of Sixes and Pair of Treys


Poker Hand #TM4180991542: Tournament #187165250, Mini Hypersonic $2.50 Hold'em No Limit - Level20(1,250/2,500) - 2025/02/03 17:16:55
Table '16' 6-max Seat #5 is the button
Seat 1: 98230d7b (70,478 in chips)
Seat 2: 39567645 (47,171 in chips)
Seat 3: a3dbf391 (81,600 in chips)
Seat 4: Hero (108,872 in chips)
Seat 5: bd01d0e (45,155 in chips)
Seat 6: d06b3360 (87,434 in chips)
Hero: posts the ante 350
bd01d0e: posts the ante 350
d06b3360: posts the ante 350
a3dbf391: posts the ante 350
98230d7b: posts the ante 350
39567645: posts the ante 350
d06b3360: posts small blind 1,250
98230d7b: posts big blind 2,500
*** HOLE CARDS ***
Dealt to 98230d7b 
Dealt to 39567645 
Dealt to a3dbf391 
Dealt to Hero [9d 3s]
Dealt to bd01d0e 
Dealt to d06b3360 
39567645: folds
a3dbf391: calls 2,500
Hero: folds
bd01d0e: folds
d06b3360: calls 1,250
98230d7b: checks
*** FLOP *** [2h Qh 4c]
d06b3360: checks
98230d7b: checks
a3dbf391: checks
*** TURN *** [2h Qh 4c] [Kd]
d06b3360: checks
98230d7b: checks
a3dbf391: bets 3,168
d06b3360: calls 3,168
98230d7b: folds
*** RIVER *** [2h Qh 4c Kd] [2c]
d06b3360: checks
a3dbf391: checks
d06b3360: shows [9s Jc] (Pair of Twos)
a3dbf391: shows [Ah 6s] (Pair of Twos)
*** SHOWDOWN ***
a3dbf391 collected 15,936 from pot
*** SUMMARY ***
Total pot 15,936 | Rake 0 | Jackpot 0 | Bingo 0 | Fortune 0 | Tax 0
Board [2h Qh 4c Kd 2c]
Seat 1: 98230d7b (big blind) folded on the Turn
Seat 2: 39567645 folded before Flop
Seat 3: a3dbf391 showed [Ah 6s] and won (15,936) with Pair of Twos
Seat 4: Hero folded before Flop
Seat 5: bd01d0e (button) folded before Flop
Seat 6: d06b3360 (small blind) showed [9s Jc] and lost with Pair of Twos


Poker Hand #TM4180158966: Tournament #187165250, Mini Hypersonic $2.50 Hold'em No Limit - Level20(1,250/2,500) - 2025/02/03 17:15:52
Table '2' 6-max Seat #2 is the button
Seat 2: 821392c2 (104,201 in chips)
Seat 3: 5e8e75d7 (102,205 in chips)
Seat 4: Hero (70,003 in chips)
Seat 5: 69e1237b (36,569 in chips)
Seat 6: 381e996e (43,091 in chips)
821392c2: posts the ante 350
5e8e75d7: posts the ante 350
Hero: posts the ante 350
69e1237b: posts the ante 350
381e996e: posts the ante 350
5e8e75d7: posts small blind 1,250
Hero: posts big blind 2,500
*** HOLE CARDS ***
Dealt to 821392c2 
Dealt to 5e8e75d7 
Dealt to Hero [Ac Qc]
Dealt to 69e1237b 
Dealt to 381e996e 
69e1237b: raises 3,250 to 5,750
381e996e: folds
821392c2: folds
5e8e75d7: folds
Hero: raises 49,250 to 55,000
69e1237b: calls 30,469 and is all-in
Uncalled bet (18,781) returned to Hero
Hero: shows [Ac Qc]
69e1237b: shows [7d 8d]
*** FLOP *** [Kh 4s Th]
*** TURN *** [Kh 4s Th] [4c]
*** RIVER *** [Kh 4s Th 4c] [3h]
*** SHOWDOWN ***
Hero collected 75,438 from pot
*** SUMMARY ***
Total pot 75,438 | Rake 0 | Jackpot 0 | Bingo 0 | Fortune 0 | Tax 0
Board [Kh 4s Th 4c 3h]
Seat 2: 821392c2 (button) folded before Flop
Seat 3: 5e8e75d7 (small blind) folded before Flop
Seat 4: Hero (big blind) showed [Ac Qc] and won (75,438) with Pair of Fours
Seat 5: 69e1237b showed [7d 8d] and lost with Pair of Fours
Seat 6: 381e996e folded before Flop


Poker Hand #TM4180158946: Tournament #187165250, Mini Hypersonic $2.50 Hold'em No Limit - Level20(1,250/2,500) - 2025/02/03 17:14:49
Table '2' 6-max Seat #1 is the button
Seat 1: e13e3da1 (41,026 in chips)
Seat 2: 821392c2 (105,801 in chips)
Seat 3: 5e8e75d7 (53,529 in chips)
Seat 4: Hero (75,353 in chips)
Seat 5: 69e1237b (36,919 in chips)
Seat 6: 381e996e (43,441 in chips)
821392c2: posts the ante 350
5e8e75d7: posts the ante 350
Hero: posts the ante 350
69e1237b: posts the ante 350
e13e3da1: posts the ante 350
381e996e: posts the ante 350
821392c2: posts small blind 1,250
5e8e75d7: posts big blind 2,500
*** HOLE CARDS ***
Dealt to e13e3da1 
Dealt to 821392c2 
Dealt to 5e8e75d7 
Dealt to Hero [Ac 9d]
Dealt to 69e1237b 
Dealt to 381e996e 
Hero: raises 2,500 to 5,000
69e1237b: folds
381e996e: folds
e13e3da1: calls 5,000
821392c2: folds
5e8e75d7: calls 2,500
*** FLOP *** [Qc Js Th]
5e8e75d7: checks
Hero: checks
e13e3da1: bets 35,676 and is all-in
5e8e75d7: raises 12,503 to 48,179 and is all-in
Hero: folds
Uncalled bet (12,503) returned to 5e8e75d7
5e8e75d7: shows [Td Qh] (Pair of Queens and Pair of Tens)
e13e3da1: shows [Ad As] (Pair of Aces)
*** TURN *** [Qc Js Th] [2h]
*** RIVER *** [Qc Js Th 2h] [Qd]
*** SHOWDOWN ***
5e8e75d7 collected 89,702 from pot
*** SUMMARY ***
Total pot 89,702 | Rake 0 | Jackpot 0 | Bingo 0 | Fortune 0 | Tax 0
Board [Qc Js Th 2h Qd]
Seat 1: e13e3da1 (button) showed [Ad As] and lost with Pair of Aces and Pair of Queens
Seat 2: 821392c2 (small blind) folded before Flop
Seat 3: 5e8e75d7 (big blind) showed [Td Qh] and won (89,702) with Queens Full over Tens
Seat 4: Hero folded on the Flop
Seat 5: 69e1237b folded before Flop
Seat 6: 381e996e folded before Flop


Poker Hand #TM4180158942: Tournament #187165250, Mini Hypersonic $2.50 Hold'em No Limit - Level20(1,250/2,500) - 2025/02/03 17:14:30
Table '2' 6-max Seat #6 is the button
Seat 1: e13e3da1 (42,626 in chips)
Seat 2: 821392c2 (102,801 in chips)
Seat 3: 5e8e75d7 (53,879 in chips)
Seat 4: Hero (75,703 in chips)
Seat 5: 69e1237b (37,269 in chips)
Seat 6: 381e996e (43,791 in chips)
821392c2: posts the ante 350
5e8e75d7: posts the ante 350
Hero: posts the ante 350
69e1237b: posts the ante 350
e13e3da1: posts the ante 350
381e996e: posts the ante 350
e13e3da1: posts small blind 1,250
821392c2: posts big blind 2,500
*** HOLE CARDS ***
Dealt to e13e3da1 
Dealt to 821392c2 
Dealt to 5e8e75d7 
Dealt to Hero [5s Jd]
Dealt to 69e1237b 
Dealt to 381e996e 
5e8e75d7: folds
Hero: folds
69e1237b: folds
381e996e: folds
e13e3da1: folds
Uncalled bet (1,250) returned to 821392c2
*** SHOWDOWN ***
821392c2 collected 4,600 from pot
*** SUMMARY ***
Total pot 4,600 | Rake 0 | Jackpot 0 | Bingo 0 | Fortune 0 | Tax 0
Seat 1: e13e3da1 (small blind) folded before Flop
Seat 2: 821392c2 (big blind) collected (4,600)
Seat 3: 5e8e75d7 folded before Flop
Seat 4: Hero folded before Flop
Seat 5: 69e1237b folded before Flop
Seat 6: 381e996e (button) folded before Flop


Poker Hand #TM4180158938: Tournament #187165250, Mini Hypersonic $2.50 Hold'em No Limit - Level20(1,250/2,500) - 2025/02/03 17:14:09
Table '2' 6-max Seat #5 is the button
Seat 1: e13e3da1 (45,476 in chips)
Seat 2: 821392c2 (103,151 in chips)
Seat 3: 5e8e75d7 (54,229 in chips)
Seat 4: Hero (76,053 in chips)
Seat 5: 69e1237b (37,619 in chips)
Seat 6: 381e996e (39,541 in chips)
821392c2: posts the ante 350
5e8e75d7: posts the ante 350
Hero: posts the ante 350
69e1237b: posts the ante 350
e13e3da1: posts the ante 350
381e996e: posts the ante 350
381e996e: posts small blind 1,250
e13e3da1: posts big blind 2,500
*** HOLE CARDS ***
Dealt to e13e3da1 
Dealt to 821392c2 
Dealt to 5e8e75d7 
Dealt to Hero [5h 2h]
Dealt to 69e1237b 
Dealt to 381e996e 
821392c2: folds
5e8e75d7: folds
Hero: folds
69e1237b: folds
381e996e: raises 2,500 to 5,000
e13e3da1: folds
Uncalled bet (2,500) returned to 381e996e
*** SHOWDOWN ***
381e996e collected 7,100 from pot
*** SUMMARY ***
Total pot 7,100 | Rake 0 | Jackpot 0 | Bingo 0 | Fortune 0 | Tax 0
Seat 1: e13e3da1 (big blind) folded before Flop
Seat 2: 821392c2 folded before Flop
Seat 3: 5e8e75d7 folded before Flop
Seat 4: Hero folded before Flop
Seat 5: 69e1237b (button) folded before Flop
Seat 6: 381e996e (small blind) collected (7,100)


Poker Hand #TM4180158933: Tournament #187165250, Mini Hypersonic $2.50 Hold'em No Limit - Level20(1,250/2,500) - 2025/02/03 17:13:41
Table '2' 6-max Seat #4 is the button
Seat 1: e13e3da1 (45,826 in chips)
Seat 2: 821392c2 (103,501 in chips)
Seat 3: 5e8e75d7 (48,729 in chips)
Seat 4: Hero (76,403 in chips)
Seat 5: 69e1237b (39,219 in chips)
Seat 6: 381e996e (42,391 in chips)
821392c2: posts the ante 350
5e8e75d7: posts the ante 350
Hero: posts the ante 350
69e1237b: posts the ante 350
e13e3da1: posts the ante 350
381e996e: posts the ante 350
69e1237b: posts small blind 1,250
381e996e: posts big blind 2,500
*** HOLE CARDS ***
Dealt to e13e3da1 
Dealt to 821392c2 
Dealt to 5e8e75d7 
Dealt to Hero [8c 6h]
Dealt to 69e1237b 
Dealt to 381e996e 
e13e3da1: folds
821392c2: folds
5e8e75d7: raises 2,750 to 5,250
Hero: folds
69e1237b: folds
381e996e: folds
Uncalled bet (2,750) returned to 5e8e75d7
*** SHOWDOWN ***
5e8e75d7 collected 8,350 from pot
*** SUMMARY ***
Total pot 8,350 | Rake 0 | Jackpot 0 | Bingo 0 | Fortune 0 | Tax 0
Seat 1: e13e3da1 folded before Flop
Seat 2: 821392c2 folded before Flop
Seat 3: 5e8e75d7 collected (8,350)
Seat 4: Hero (button) folded before Flop
Seat 5: 69e1237b (small blind) folded before Flop
Seat 6: 381e996e (big blind) folded before Flop


Poker Hand #TM4180158925: Tournament #187165250, Mini Hypersonic $2.50 Hold'em No Limit - Level19(1,000/2,000) - 2025/02/03 17:12:53
Table '2' 6-max Seat #3 is the button
Seat 1: e13e3da1 (46,126 in chips)
Seat 2: 821392c2 (74,777 in chips)
Seat 3: 5e8e75d7 (49,029 in chips)
Seat 4: Hero (77,703 in chips)
Seat 5: 69e1237b (41,519 in chips)
Seat 6: 381e996e (66,915 in chips)
821392c2: posts the ante 300
5e8e75d7: posts the ante 300
Hero: posts the ante 300
69e1237b: posts the ante 300
e13e3da1: posts the ante 300
381e996e: posts the ante 300
Hero: posts small blind 1,000
69e1237b: posts big blind 2,000
*** HOLE CARDS ***
Dealt to e13e3da1 
Dealt to 821392c2 
Dealt to 5e8e75d7 
Dealt to Hero [9d Tc]
Dealt to 69e1237b 
Dealt to 381e996e 
381e996e: raises 2,000 to 4,000
e13e3da1: folds
821392c2: calls 4,000
5e8e75d7: folds
Hero: folds
69e1237b: folds
*** FLOP *** [Qd 3h 3d]
381e996e: bets 4,224
821392c2: calls 4,224
*** TURN *** [Qd 3h 3d] [Jc]
381e996e: bets 16,000
821392c2: raises 50,253 to 66,253 and is all-in
381e996e: folds
Uncalled bet (50,253) returned to 821392c2
*** SHOWDOWN ***
821392c2 collected 53,248 from pot
*** SUMMARY ***
Total pot 53,248 | Rake 0 | Jackpot 0 | Bingo 0 | Fortune 0 | Tax 0
Board [Qd 3h 3d Jc]
Seat 1: e13e3da1 folded before Flop
Seat 2: 821392c2 won (53,248)
Seat 3: 5e8e75d7 (button) folded before Flop
Seat 4: Hero (small blind) folded before Flop
Seat 5: 69e1237b (big blind) folded before Flop
Seat 6: 381e996e folded on the Turn


Poker Hand #TM4180158918: Tournament #187165250, Mini Hypersonic $2.50 Hold'em No Limit - Level19(1,000/2,000) - 2025/02/03 17:12:29
Table '2' 6-max Seat #2 is the button
Seat 1: e13e3da1 (46,426 in chips)
Seat 2: 821392c2 (75,077 in chips)
Seat 3: 5e8e75d7 (51,329 in chips)
Seat 4: Hero (74,503 in chips)
Seat 5: 69e1237b (41,819 in chips)
821392c2: posts the ante 300
5e8e75d7: posts the ante 300
Hero: posts the ante 300
69e1237b: posts the ante 300
e13e3da1: posts the ante 300
5e8e75d7: posts small blind 1,000
Hero: posts big blind 2,000
*** HOLE CARDS ***
Dealt to e13e3da1 
Dealt to 821392c2 
Dealt to 5e8e75d7 
Dealt to Hero [8h 8s]
Dealt to 69e1237b 
69e1237b: folds
e13e3da1: folds
821392c2: folds
5e8e75d7: calls 1,000
Hero: raises 4,000 to 6,000
5e8e75d7: folds
Uncalled bet (4,000) returned to Hero
*** SHOWDOWN ***
Hero collected 5,500 from pot
*** SUMMARY ***
Total pot 5,500 | Rake 0 | Jackpot 0 | Bingo 0 | Fortune 0 | Tax 0
Seat 1: e13e3da1 folded before Flop
Seat 2: 821392c2 (button) folded before Flop
Seat 3: 5e8e75d7 (small blind) folded before Flop
Seat 4: Hero (big blind) collected (5,500)
Seat 5: 69e1237b folded before Flop


Poker Hand #TM4180158915: Tournament #187165250, Mini Hypersonic $2.50 Hold'em No Limit - Level19(1,000/2,000) - 2025/02/03 17:12:08
Table '2' 6-max Seat #1 is the button
Seat 1: e13e3da1 (46,726 in chips)
Seat 2: 821392c2 (76,377 in chips)
Seat 3: 5e8e75d7 (53,629 in chips)
Seat 4: Hero (70,303 in chips)
Seat 5: 69e1237b (42,119 in chips)
821392c2: posts the ante 300
5e8e75d7: posts the ante 300
Hero: posts the ante 300
69e1237b: posts the ante 300
e13e3da1: posts the ante 300
821392c2: posts small blind 1,000
5e8e75d7: posts big blind 2,000
*** HOLE CARDS ***
Dealt to e13e3da1 
Dealt to 821392c2 
Dealt to 5e8e75d7 
Dealt to Hero [3c 3h]
Dealt to 69e1237b 
Hero: raises 2,000 to 4,000
69e1237b: folds
e13e3da1: folds
821392c2: folds
5e8e75d7: folds
Uncalled bet (2,000) returned to Hero
*** SHOWDOWN ***
Hero collected 6,500 from pot
*** SUMMARY ***
Total pot 6,500 | Rake 0 | Jackpot 0 | Bingo 0 | Fortune 0 | Tax 0
Seat 1: e13e3da1 (button) folded before Flop
Seat 2: 821392c2 (small blind) folded before Flop
Seat 3: 5e8e75d7 (big blind) folded before Flop
Seat 4: Hero collected (6,500)
Seat 5: 69e1237b folded before Flop


Poker Hand #TM4180158909: Tournament #187165250, Mini Hypersonic $2.50 Hold'em No Limit - Level19(1,000/2,000) - 2025/02/03 17:11:22
Table '2' 6-max Seat #4 is the button
Seat 1: e13e3da1 (49,026 in chips)
Seat 2: 821392c2 (40,631 in chips)
Seat 3: 5e8e75d7 (53,929 in chips)
Seat 4: Hero (70,603 in chips)
Seat 6: e371d20c (32,846 in chips)
821392c2: posts the ante 300
5e8e75d7: posts the ante 300
Hero: posts the ante 300
e13e3da1: posts the ante 300
e371d20c: posts the ante 300
e371d20c: posts small blind 1,000
e13e3da1: posts big blind 2,000
*** HOLE CARDS ***
Dealt to e13e3da1 
Dealt to 821392c2 
Dealt to 5e8e75d7 
Dealt to Hero [4d 6h]
Dealt to e371d20c 
821392c2: raises 2,000 to 4,000
5e8e75d7: folds
Hero: folds
e371d20c: raises 28,546 to 32,546 and is all-in
e13e3da1: folds
821392c2: calls 28,546
e371d20c: shows [Qh Qs]
821392c2: shows [Ah Ks]
*** FLOP *** [6c Ad 8d]
*** TURN *** [6c Ad 8d] [7s]
*** RIVER *** [6c Ad 8d 7s] [Jh]
*** SHOWDOWN ***
821392c2 collected 68,592 from pot
*** SUMMARY ***
Total pot 68,592 | Rake 0 | Jackpot 0 | Bingo 0 | Fortune 0 | Tax 0
Board [6c Ad 8d 7s Jh]
Seat 1: e13e3da1 (big blind) folded before Flop
Seat 2: 821392c2 showed [Ah Ks] and won (68,592) with Pair of Aces
Seat 3: 5e8e75d7 folded before Flop
Seat 4: Hero (button) folded before Flop
Seat 6: e371d20c (small blind) showed [Qh Qs] and lost with Pair of Queens


Poker Hand #TM4180158903: Tournament #187165250, Mini Hypersonic $2.50 Hold'em No Limit - Level19(1,000/2,000) - 2025/02/03 17:10:39
Table '2' 6-max Seat #3 is the button
Seat 1: e13e3da1 (49,326 in chips)
Seat 3: 5e8e75d7 (54,229 in chips)
Seat 4: Hero (63,214 in chips)
Seat 5: d7c2f8c8 (6,489 in chips)
Seat 6: e371d20c (33,146 in chips)
5e8e75d7: posts the ante 300
Hero: posts the ante 300
e13e3da1: posts the ante 300
d7c2f8c8: posts the ante 300
e371d20c: posts the ante 300
Hero: posts small blind 1,000
d7c2f8c8: posts big blind 2,000
*** HOLE CARDS ***
Dealt to e13e3da1 
Dealt to 5e8e75d7 
Dealt to Hero [Js Td]
Dealt to d7c2f8c8 
Dealt to e371d20c 
e371d20c: folds
e13e3da1: folds
5e8e75d7: folds
Hero: raises 6,000 to 8,000
d7c2f8c8: calls 4,189 and is all-in
Uncalled bet (1,811) returned to Hero
Hero: shows [Js Td]
d7c2f8c8: shows [Jh 9c]
*** FLOP *** [8d Qs 5s]
*** TURN *** [8d Qs 5s] [9s]
*** RIVER *** [8d Qs 5s 9s] [2s]
e371d20c: shows [3c Th] (Queen-High)
*** SHOWDOWN ***
Hero collected 13,878 from pot
*** SUMMARY ***
Total pot 13,878 | Rake 0 | Jackpot 0 | Bingo 0 | Fortune 0 | Tax 0
Board [8d Qs 5s 9s 2s]
Seat 1: e13e3da1 folded before Flop
Seat 3: 5e8e75d7 (button) folded before Flop
Seat 4: Hero (small blind) showed [Js Td] and won (13,878) with Queen High Flush
Seat 5: d7c2f8c8 (big blind) showed [Jh 9c] and lost with Pair of Nines
Seat 6: e371d20c folded before Flop


Poker Hand #TM4180158893: Tournament #187165250, Mini Hypersonic $2.50 Hold'em No Limit - Level19(1,000/2,000) - 2025/02/03 17:09:33
Table '2' 6-max Seat #1 is the button
Seat 1: e13e3da1 (49,626 in chips)
Seat 2: 58f968ce (8,120 in chips)
Seat 3: 5e8e75d7 (56,529 in chips)
Seat 4: Hero (51,894 in chips)
Seat 5: d7c2f8c8 (6,789 in chips)
Seat 6: e371d20c (33,446 in chips)
5e8e75d7: posts the ante 300
Hero: posts the ante 300
e13e3da1: posts the ante 300
d7c2f8c8: posts the ante 300
e371d20c: posts the ante 300
58f968ce: posts the ante 300
58f968ce: posts small blind 1,000
5e8e75d7: posts big blind 2,000
*** HOLE CARDS ***
Dealt to e13e3da1 
Dealt to 58f968ce 
Dealt to 5e8e75d7 
Dealt to Hero [7d 7c]
Dealt to d7c2f8c8 
Dealt to e371d20c 
Hero: raises 2,000 to 4,000
d7c2f8c8: folds
e371d20c: folds
e13e3da1: folds
58f968ce: raises 3,820 to 7,820 and is all-in
5e8e75d7: folds
Hero: calls 3,820
58f968ce: shows [5h Ac]
Hero: shows [7d 7c]
*** FLOP *** [2c 5d Qc]
*** TURN *** [2c 5d Qc] [3s]
*** RIVER *** [2c 5d Qc 3s] [9s]
e371d20c: shows [2d 6s] (Pair of Twos)
*** SHOWDOWN ***
Hero collected 19,440 from pot
*** SUMMARY ***
Total pot 19,440 | Rake 0 | Jackpot 0 | Bingo 0 | Fortune 0 | Tax 0
Board [2c 5d Qc 3s 9s]
Seat 1: e13e3da1 (button) folded before Flop
Seat 2: 58f968ce (small blind) showed [5h Ac] and lost with Pair of Fives
Seat 3: 5e8e75d7 (big blind) folded before Flop
Seat 4: Hero showed [7d 7c] and won (19,440) with Pair of Sevens
Seat 5: d7c2f8c8 folded before Flop
Seat 6: e371d20c folded before Flop


Poker Hand #TM4180158882: Tournament #187165250, Mini Hypersonic $2.50 Hold'em No Limit - Level18(800/1,600) - 2025/02/03 17:08:28
Table '2' 6-max Seat #6 is the button
Seat 1: e13e3da1 (50,676 in chips)
Seat 2: 58f968ce (11,570 in chips)
Seat 3: 5e8e75d7 (56,779 in chips)
Seat 4: Hero (46,644 in chips)
Seat 5: d7c2f8c8 (7,039 in chips)
Seat 6: e371d20c (33,696 in chips)
5e8e75d7: posts the ante 250
Hero: posts the ante 250
d7c2f8c8: posts the ante 250
e13e3da1: posts the ante 250
e371d20c: posts the ante 250
58f968ce: posts the ante 250
e13e3da1: posts small blind 800
58f968ce: posts big blind 1,600
*** HOLE CARDS ***
Dealt to e13e3da1 
Dealt to 58f968ce 
Dealt to 5e8e75d7 
Dealt to Hero [9d Ac]
Dealt to d7c2f8c8 
Dealt to e371d20c 
5e8e75d7: folds
Hero: raises 1,600 to 3,200
d7c2f8c8: folds
e371d20c: folds
e13e3da1: folds
58f968ce: calls 1,600
*** FLOP *** [4s Jc 8c]
58f968ce: checks
Hero: bets 2,175
58f968ce: folds
Uncalled bet (2,175) returned to Hero
*** SHOWDOWN ***
Hero collected 8,700 from pot
*** SUMMARY ***
Total pot 8,700 | Rake 0 | Jackpot 0 | Bingo 0 | Fortune 0 | Tax 0
Board [4s Jc 8c]
Seat 1: e13e3da1 (small blind) folded before Flop
Seat 2: 58f968ce (big blind) folded on the Flop
Seat 3: 5e8e75d7 folded before Flop
Seat 4: Hero won (8,700)
Seat 5: d7c2f8c8 folded before Flop
Seat 6: e371d20c (button) folded before Flop


Poker Hand #TM4180158870: Tournament #187165250, Mini Hypersonic $2.50 Hold'em No Limit - Level18(800/1,600) - 2025/02/03 17:07:00
Table '2' 6-max Seat #5 is the button
Seat 1: e13e3da1 (24,438 in chips)
Seat 2: 58f968ce (11,820 in chips)
Seat 3: 5e8e75d7 (57,029 in chips)
Seat 4: Hero (46,894 in chips)
Seat 5: d7c2f8c8 (31,477 in chips)
Seat 6: e371d20c (34,746 in chips)
5e8e75d7: posts the ante 250
Hero: posts the ante 250
d7c2f8c8: posts the ante 250
e13e3da1: posts the ante 250
58f968ce: posts the ante 250
e371d20c: posts the ante 250
e371d20c: posts small blind 800
e13e3da1: posts big blind 1,600
*** HOLE CARDS ***
Dealt to e13e3da1 
Dealt to 58f968ce 
Dealt to 5e8e75d7 
Dealt to Hero [Ah 5c]
Dealt to d7c2f8c8 
Dealt to e371d20c 
58f968ce: folds
5e8e75d7: folds
Hero: folds
d7c2f8c8: raises 1,600 to 3,200
e371d20c: folds
e13e3da1: calls 1,600
*** FLOP *** [6d Ks Kc]
e13e3da1: checks
d7c2f8c8: bets 2,871
e13e3da1: calls 2,871
*** TURN *** [6d Ks Kc] [Tc]
e13e3da1: checks
d7c2f8c8: checks
*** RIVER *** [6d Ks Kc Tc] [3c]
e13e3da1: bets 7,221
d7c2f8c8: raises 17,935 to 25,156 and is all-in
e13e3da1: calls 10,896 and is all-in
Uncalled bet (7,039) returned to d7c2f8c8
d7c2f8c8: shows [Ac 9c] (Ace High Flush)
e13e3da1: shows [Kd Ts] (Kings Full over Tens)
*** SHOWDOWN ***
e13e3da1 collected 50,676 from pot
*** SUMMARY ***
Total pot 50,676 | Rake 0 | Jackpot 0 | Bingo 0 | Fortune 0 | Tax 0
Board [6d Ks Kc Tc 3c]
Seat 1: e13e3da1 (big blind) showed [Kd Ts] and won (50,676) with Kings Full over Tens
Seat 2: 58f968ce folded before Flop
Seat 3: 5e8e75d7 folded before Flop
Seat 4: Hero folded before Flop
Seat 5: d7c2f8c8 (button) showed [Ac 9c] and lost with Ace High Flush
Seat 6: e371d20c (small blind) folded before Flop


Poker Hand #TM4180158862: Tournament #187165250, Mini Hypersonic $2.50 Hold'em No Limit - Level18(800/1,600) - 2025/02/03 17:06:16
Table '2' 6-max Seat #4 is the button
Seat 1: e13e3da1 (24,688 in chips)
Seat 2: 58f968ce (12,070 in chips)
Seat 4: Hero (47,144 in chips)
Seat 5: d7c2f8c8 (33,327 in chips)
Seat 6: e371d20c (32,146 in chips)
Hero: posts the ante 250
e13e3da1: posts the ante 250
d7c2f8c8: posts the ante 250
58f968ce: posts the ante 250
e371d20c: posts the ante 250
d7c2f8c8: posts small blind 800
e371d20c: posts big blind 1,600
*** HOLE CARDS ***
Dealt to e13e3da1 
Dealt to 58f968ce 
Dealt to Hero [4h Qs]
Dealt to d7c2f8c8 
Dealt to e371d20c 
e13e3da1: folds
58f968ce: folds
Hero: folds
d7c2f8c8: calls 800
e371d20c: raises 30,296 to 31,896 and is all-in
d7c2f8c8: folds
Uncalled bet (30,296) returned to e371d20c
*** SHOWDOWN ***
e371d20c collected 4,450 from pot
*** SUMMARY ***
Total pot 4,450 | Rake 0 | Jackpot 0 | Bingo 0 | Fortune 0 | Tax 0
Seat 1: e13e3da1 folded before Flop
Seat 2: 58f968ce folded before Flop
Seat 4: Hero (button) folded before Flop
Seat 5: d7c2f8c8 (small blind) folded before Flop
Seat 6: e371d20c (big blind) collected (4,450)


Poker Hand #TM4180158850: Tournament #187165250, Mini Hypersonic $2.50 Hold'em No Limit - Level18(800/1,600) - 2025/02/03 17:05:29
Table '2' 6-max Seat #2 is the button
Seat 1: e13e3da1 (24,938 in chips)
Seat 2: 58f968ce (12,320 in chips)
Seat 3: 880ac6c (5,410 in chips)
Seat 4: Hero (40,734 in chips)
Seat 5: d7c2f8c8 (33,577 in chips)
Seat 6: e371d20c (32,396 in chips)
880ac6c: posts the ante 250
Hero: posts the ante 250
e13e3da1: posts the ante 250
d7c2f8c8: posts the ante 250
58f968ce: posts the ante 250
e371d20c: posts the ante 250
880ac6c: posts small blind 800
Hero: posts big blind 1,600
*** HOLE CARDS ***
Dealt to e13e3da1 
Dealt to 58f968ce 
Dealt to 880ac6c 
Dealt to Hero [3h Th]
Dealt to d7c2f8c8 
Dealt to e371d20c 
d7c2f8c8: folds
e371d20c: folds
e13e3da1: folds
58f968ce: folds
880ac6c: raises 3,560 to 5,160 and is all-in
Hero: calls 3,560
880ac6c: shows [3c 5c]
Hero: shows [3h Th]
*** FLOP *** [9d 5h Td]
*** TURN *** [9d 5h Td] [6s]
*** RIVER *** [9d 5h Td 6s] [Ad]
*** SHOWDOWN ***
Hero collected 11,820 from pot
*** SUMMARY ***
Total pot 11,820 | Rake 0 | Jackpot 0 | Bingo 0 | Fortune 0 | Tax 0
Board [9d 5h Td 6s Ad]
Seat 1: e13e3da1 folded before Flop
Seat 2: 58f968ce (button) folded before Flop
Seat 3: 880ac6c (small blind) showed [3c 5c] and lost with Pair of Fives
Seat 4: Hero (big blind) showed [3h Th] and won (11,820) with Pair of Tens
Seat 5: d7c2f8c8 folded before Flop
Seat 6: e371d20c folded before Flop


Poker Hand #TM4180158841: Tournament #187165250, Mini Hypersonic $2.50 Hold'em No Limit - Level17(700/1,400) - 2025/02/03 17:04:26
Table '2' 6-max Seat #1 is the button
Seat 1: e13e3da1 (18,958 in chips)
Seat 2: 58f968ce (13,220 in chips)
Seat 3: 880ac6c (10,090 in chips)
Seat 4: Hero (40,934 in chips)
Seat 5: d7c2f8c8 (33,777 in chips)
880ac6c: posts the ante 200
Hero: posts the ante 200
e13e3da1: posts the ante 200
d7c2f8c8: posts the ante 200
58f968ce: posts the ante 200
58f968ce: posts small blind 700
880ac6c: posts big blind 1,400
*** HOLE CARDS ***
Dealt to e13e3da1 
Dealt to 58f968ce 
Dealt to 880ac6c 
Dealt to Hero [3s 2s]
Dealt to d7c2f8c8 
Hero: folds
d7c2f8c8: folds
e13e3da1: raises 1,680 to 3,080
58f968ce: folds
880ac6c: calls 1,680
*** FLOP *** [8h Kc Ts]
880ac6c: checks
e13e3da1: checks
*** TURN *** [8h Kc Ts] [2h]
880ac6c: checks
e13e3da1: checks
*** RIVER *** [8h Kc Ts 2h] [4c]
880ac6c: bets 1,400
e13e3da1: calls 1,400
880ac6c: shows [4h 6h] (Pair of Fours)
e13e3da1: shows [4s As] (Pair of Fours)
*** SHOWDOWN ***
e13e3da1 collected 10,660 from pot
*** SUMMARY ***
Total pot 10,660 | Rake 0 | Jackpot 0 | Bingo 0 | Fortune 0 | Tax 0
Board [8h Kc Ts 2h 4c]
Seat 1: e13e3da1 (button) showed [4s As] and won (10,660) with Pair of Fours
Seat 2: 58f968ce (small blind) folded before Flop
Seat 3: 880ac6c (big blind) showed [4h 6h] and lost with Pair of Fours
Seat 4: Hero folded before Flop
Seat 5: d7c2f8c8 folded before Flop


Poker Hand #TM4180158832: Tournament #187165250, Mini Hypersonic $2.50 Hold'em No Limit - Level17(700/1,400) - 2025/02/03 17:03:29
Table '2' 6-max Seat #5 is the button
Seat 1: e13e3da1 (20,558 in chips)
Seat 2: 58f968ce (13,420 in chips)
Seat 3: 880ac6c (10,290 in chips)
Seat 4: Hero (41,134 in chips)
Seat 5: d7c2f8c8 (21,363 in chips)
Seat 6: 8638c512 (10,214 in chips)
880ac6c: posts the ante 200
Hero: posts the ante 200
8638c512: posts the ante 200
d7c2f8c8: posts the ante 200
e13e3da1: posts the ante 200
58f968ce: posts the ante 200
8638c512: posts small blind 700
e13e3da1: posts big blind 1,400
*** HOLE CARDS ***
Dealt to e13e3da1 
Dealt to 58f968ce 
Dealt to 880ac6c 
Dealt to Hero [5d 4c]
Dealt to d7c2f8c8 
Dealt to 8638c512 
58f968ce: folds
880ac6c: folds
Hero: folds
d7c2f8c8: raises 19,763 to 21,163 and is all-in
8638c512: calls 9,314 and is all-in
e13e3da1: folds
Uncalled bet (11,149) returned to d7c2f8c8
d7c2f8c8: shows [Qs Ks]
8638c512: shows [9c 9s]
*** FLOP *** [Td 5c Ad]
*** TURN *** [Td 5c Ad] [Ac]
*** RIVER *** [Td 5c Ad Ac] [Tc]
*** SHOWDOWN ***
d7c2f8c8 collected 22,628 from pot
*** SUMMARY ***
Total pot 22,628 | Rake 0 | Jackpot 0 | Bingo 0 | Fortune 0 | Tax 0
Board [Td 5c Ad Ac Tc]
Seat 1: e13e3da1 (big blind) folded before Flop
Seat 2: 58f968ce folded before Flop
Seat 3: 880ac6c folded before Flop
Seat 4: Hero folded before Flop
Seat 5: d7c2f8c8 (button) showed [Qs Ks] and won (22,628) with Pair of Aces and Pair of Tens
Seat 6: 8638c512 (small blind) showed [9c 9s] and lost with Pair of Aces and Pair of Tens


Poker Hand #TM4180158824: Tournament #187165250, Mini Hypersonic $2.50 Hold'em No Limit - Level17(700/1,400) - 2025/02/03 17:02:54
Table '2' 6-max Seat #4 is the button
Seat 1: e13e3da1 (20,758 in chips)
Seat 2: 58f968ce (13,620 in chips)
Seat 3: 880ac6c (10,490 in chips)
Seat 4: Hero (38,034 in chips)
Seat 5: d7c2f8c8 (22,263 in chips)
Seat 6: 8638c512 (11,814 in chips)
880ac6c: posts the ante 200
Hero: posts the ante 200
8638c512: posts the ante 200
e13e3da1: posts the ante 200
d7c2f8c8: posts the ante 200
58f968ce: posts the ante 200
d7c2f8c8: posts small blind 700
8638c512: posts big blind 1,400
*** HOLE CARDS ***
Dealt to e13e3da1 
Dealt to 58f968ce 
Dealt to 880ac6c 
Dealt to Hero [Ks Qd]
Dealt to d7c2f8c8 
Dealt to 8638c512 
e13e3da1: folds
58f968ce: folds
880ac6c: folds
Hero: raises 1,400 to 2,800
d7c2f8c8: folds
8638c512: folds
Uncalled bet (1,400) returned to Hero
*** SHOWDOWN ***
Hero collected 4,700 from pot
*** SUMMARY ***
Total pot 4,700 | Rake 0 | Jackpot 0 | Bingo 0 | Fortune 0 | Tax 0
Seat 1: e13e3da1 folded before Flop
Seat 2: 58f968ce folded before Flop
Seat 3: 880ac6c folded before Flop
Seat 4: Hero (button) collected (4,700)
Seat 5: d7c2f8c8 (small blind) folded before Flop
Seat 6: 8638c512 (big blind) folded before Flop


Poker Hand #TM4180158819: Tournament #187165250, Mini Hypersonic $2.50 Hold'em No Limit - Level17(700/1,400) - 2025/02/03 17:02:25
Table '2' 6-max Seat #3 is the button
Seat 1: e13e3da1 (20,958 in chips)
Seat 2: 58f968ce (10,520 in chips)
Seat 3: 880ac6c (10,690 in chips)
Seat 4: Hero (38,934 in chips)
Seat 5: d7c2f8c8 (23,863 in chips)
Seat 6: 8638c512 (12,014 in chips)
880ac6c: posts the ante 200
Hero: posts the ante 200
8638c512: posts the ante 200
e13e3da1: posts the ante 200
d7c2f8c8: posts the ante 200
58f968ce: posts the ante 200
Hero: posts small blind 700
d7c2f8c8: posts big blind 1,400
*** HOLE CARDS ***
Dealt to e13e3da1 
Dealt to 58f968ce 
Dealt to 880ac6c 
Dealt to Hero [2c Qc]
Dealt to d7c2f8c8 
Dealt to 8638c512 
8638c512: folds
e13e3da1: folds
58f968ce: raises 8,920 to 10,320 and is all-in
880ac6c: folds
Hero: folds
d7c2f8c8: folds
Uncalled bet (8,920) returned to 58f968ce
*** SHOWDOWN ***
58f968ce collected 4,700 from pot
*** SUMMARY ***
Total pot 4,700 | Rake 0 | Jackpot 0 | Bingo 0 | Fortune 0 | Tax 0
Seat 1: e13e3da1 folded before Flop
Seat 2: 58f968ce collected (4,700)
Seat 3: 880ac6c (button) folded before Flop
Seat 4: Hero (small blind) folded before Flop
Seat 5: d7c2f8c8 (big blind) folded before Flop
Seat 6: 8638c512 folded before Flop


Poker Hand #TM4180158814: Tournament #187165250, Mini Hypersonic $2.50 Hold'em No Limit - Level17(700/1,400) - 2025/02/03 17:01:47
Table '2' 6-max Seat #2 is the button
Seat 1: e13e3da1 (21,158 in chips)
Seat 2: 58f968ce (10,720 in chips)
Seat 3: 880ac6c (11,590 in chips)
Seat 4: Hero (40,534 in chips)
Seat 5: d7c2f8c8 (24,063 in chips)
Seat 6: 8638c512 (8,914 in chips)
880ac6c: posts the ante 200
Hero: posts the ante 200
8638c512: posts the ante 200
e13e3da1: posts the ante 200
d7c2f8c8: posts the ante 200
58f968ce: posts the ante 200
880ac6c: posts small blind 700
Hero: posts big blind 1,400
*** HOLE CARDS ***
Dealt to e13e3da1 
Dealt to 58f968ce 
Dealt to 880ac6c 
Dealt to Hero [2d Th]
Dealt to d7c2f8c8 
Dealt to 8638c512 
d7c2f8c8: folds
8638c512: raises 7,314 to 8,714 and is all-in
e13e3da1: folds
58f968ce: folds
880ac6c: folds
Hero: folds
Uncalled bet (7,314) returned to 8638c512
*** SHOWDOWN ***
8638c512 collected 4,700 from pot
*** SUMMARY ***
Total pot 4,700 | Rake 0 | Jackpot 0 | Bingo 0 | Fortune 0 | Tax 0
Seat 1: e13e3da1 folded before Flop
Seat 2: 58f968ce (button) folded before Flop
Seat 3: 880ac6c (small blind) folded before Flop
Seat 4: Hero (big blind) folded before Flop
Seat 5: d7c2f8c8 folded before Flop
Seat 6: 8638c512 collected (4,700)


Poker Hand #TM4180158809: Tournament #187165250, Mini Hypersonic $2.50 Hold'em No Limit - Level16(600/1,200) - 2025/02/03 17:01:20
Table '2' 6-max Seat #1 is the button
Seat 1: e13e3da1 (21,338 in chips)
Seat 2: 58f968ce (8,620 in chips)
Seat 3: 880ac6c (12,970 in chips)
Seat 4: Hero (40,714 in chips)
Seat 5: d7c2f8c8 (24,243 in chips)
Seat 6: 8638c512 (9,094 in chips)
880ac6c: posts the ante 180
Hero: posts the ante 180
8638c512: posts the ante 180
e13e3da1: posts the ante 180
d7c2f8c8: posts the ante 180
58f968ce: posts the ante 180
58f968ce: posts small blind 600
880ac6c: posts big blind 1,200
*** HOLE CARDS ***
Dealt to e13e3da1 
Dealt to 58f968ce 
Dealt to 880ac6c 
Dealt to Hero [9d 5d]
Dealt to d7c2f8c8 
Dealt to 8638c512 
Hero: folds
d7c2f8c8: folds
8638c512: folds
e13e3da1: folds
58f968ce: raises 7,240 to 8,440 and is all-in
880ac6c: folds
Uncalled bet (7,240) returned to 58f968ce
*** SHOWDOWN ***
58f968ce collected 3,480 from pot
*** SUMMARY ***
Total pot 3,480 | Rake 0 | Jackpot 0 | Bingo 0 | Fortune 0 | Tax 0
Seat 1: e13e3da1 (button) folded before Flop
Seat 2: 58f968ce (small blind) collected (3,480)
Seat 3: 880ac6c (big blind) folded before Flop
Seat 4: Hero folded before Flop
Seat 5: d7c2f8c8 folded before Flop
Seat 6: 8638c512 folded before Flop


Poker Hand #TM4180158803: Tournament #187165250, Mini Hypersonic $2.50 Hold'em No Limit - Level16(600/1,200) - 2025/02/03 16:54:56
Table '2' 6-max Seat #6 is the button
Seat 1: e13e3da1 (40,735 in chips)
Seat 2: 58f968ce (10,000 in chips)
Seat 3: 880ac6c (13,150 in chips)
Seat 4: Hero (19,397 in chips)
Seat 5: d7c2f8c8 (24,423 in chips)
Seat 6: 8638c512 (9,274 in chips)
880ac6c: posts the ante 180
Hero: posts the ante 180
8638c512: posts the ante 180
d7c2f8c8: posts the ante 180
e13e3da1: posts the ante 180
58f968ce: posts the ante 180
e13e3da1: posts small blind 600
58f968ce: posts big blind 1,200
*** HOLE CARDS ***
Dealt to e13e3da1 
Dealt to 58f968ce 
Dealt to 880ac6c 
Dealt to Hero [Ah Qh]
Dealt to d7c2f8c8 
Dealt to 8638c512 
880ac6c: folds
Hero: raises 1,200 to 2,400
d7c2f8c8: folds
8638c512: folds
e13e3da1: calls 1,800
58f968ce: folds
*** FLOP *** [Ad 9s 2d]
e13e3da1: checks
Hero: bets 1,680
e13e3da1: raises 4,646 to 6,326
Hero: calls 4,646
*** TURN *** [Ad 9s 2d] [8s]
e13e3da1: bets 10,800
Hero: calls 10,491 and is all-in
Uncalled bet (309) returned to e13e3da1
e13e3da1: shows [7c Ac] (Pair of Aces)
Hero: shows [Ah Qh] (Pair of Aces)
*** RIVER *** [Ad 9s 2d 8s] [6c]
*** SHOWDOWN ***
Hero collected 40,714 from pot
*** SUMMARY ***
Total pot 40,714 | Rake 0 | Jackpot 0 | Bingo 0 | Fortune 0 | Tax 0
Board [Ad 9s 2d 8s 6c]
Seat 1: e13e3da1 (small blind) showed [7c Ac] and lost with Pair of Aces
Seat 2: 58f968ce (big blind) folded before Flop
Seat 3: 880ac6c folded before Flop
Seat 4: Hero showed [Ah Qh] and won (40,714) with Pair of Aces
Seat 5: d7c2f8c8 folded before Flop
Seat 6: 8638c512 (button) folded before Flop


Poker Hand #TM4180158796: Tournament #187165250, Mini Hypersonic $2.50 Hold'em No Limit - Level16(600/1,200) - 2025/02/03 16:54:22
Table '2' 6-max Seat #5 is the button
Seat 1: e13e3da1 (42,115 in chips)
Seat 2: 58f968ce (10,180 in chips)
Seat 3: 880ac6c (10,450 in chips)
Seat 4: Hero (19,577 in chips)
Seat 5: d7c2f8c8 (24,603 in chips)
Seat 6: 8638c512 (10,054 in chips)
880ac6c: posts the ante 180
Hero: posts the ante 180
8638c512: posts the ante 180
d7c2f8c8: posts the ante 180
e13e3da1: posts the ante 180
58f968ce: posts the ante 180
8638c512: posts small blind 600
e13e3da1: posts big blind 1,200
*** HOLE CARDS ***
Dealt to e13e3da1 
Dealt to 58f968ce 
Dealt to 880ac6c 
Dealt to Hero [4s 4d]
Dealt to d7c2f8c8 
Dealt to 8638c512 
58f968ce: folds
880ac6c: raises 9,070 to 10,270 and is all-in
Hero: folds
d7c2f8c8: folds
8638c512: folds
e13e3da1: folds
Uncalled bet (9,070) returned to 880ac6c
*** SHOWDOWN ***
880ac6c collected 4,080 from pot
*** SUMMARY ***
Total pot 4,080 | Rake 0 | Jackpot 0 | Bingo 0 | Fortune 0 | Tax 0
Seat 1: e13e3da1 (big blind) folded before Flop
Seat 2: 58f968ce folded before Flop
Seat 3: 880ac6c collected (4,080)
Seat 4: Hero folded before Flop
Seat 5: d7c2f8c8 (button) folded before Flop
Seat 6: 8638c512 (small blind) folded before Flop


Poker Hand #TM4180158793: Tournament #187165250, Mini Hypersonic $2.50 Hold'em No Limit - Level16(600/1,200) - 2025/02/03 16:53:51
Table '2' 6-max Seat #4 is the button
Seat 1: e13e3da1 (42,295 in chips)
Seat 2: 58f968ce (10,360 in chips)
Seat 3: 880ac6c (10,630 in chips)
Seat 4: Hero (19,757 in chips)
Seat 5: d7c2f8c8 (22,503 in chips)
Seat 6: 8638c512 (11,434 in chips)
880ac6c: posts the ante 180
Hero: posts the ante 180
8638c512: posts the ante 180
e13e3da1: posts the ante 180
d7c2f8c8: posts the ante 180
58f968ce: posts the ante 180
d7c2f8c8: posts small blind 600
8638c512: posts big blind 1,200
*** HOLE CARDS ***
Dealt to e13e3da1 
Dealt to 58f968ce 
Dealt to 880ac6c 
Dealt to Hero [Jh 7s]
Dealt to d7c2f8c8 
Dealt to 8638c512 
e13e3da1: folds
58f968ce: folds
880ac6c: folds
Hero: folds
d7c2f8c8: raises 19,200 to 20,400
8638c512: folds
Uncalled bet (19,200) returned to d7c2f8c8
*** SHOWDOWN ***
d7c2f8c8 collected 3,480 from pot
*** SUMMARY ***
Total pot 3,480 | Rake 0 | Jackpot 0 | Bingo 0 | Fortune 0 | Tax 0
Seat 1: e13e3da1 folded before Flop
Seat 2: 58f968ce folded before Flop
Seat 3: 880ac6c folded before Flop
Seat 4: Hero (button) folded before Flop
Seat 5: d7c2f8c8 (small blind) collected (3,480)
Seat 6: 8638c512 (big blind) folded before Flop


Poker Hand #TM4180158779: Tournament #187165250, Mini Hypersonic $2.50 Hold'em No Limit - Level16(600/1,200) - 2025/02/03 16:52:58
Table '2' 6-max Seat #3 is the button
Seat 1: e13e3da1 (37,555 in chips)
Seat 2: 58f968ce (10,540 in chips)
Seat 3: 880ac6c (10,810 in chips)
Seat 4: Hero (22,577 in chips)
Seat 5: d7c2f8c8 (23,883 in chips)
Seat 6: 8638c512 (11,614 in chips)
880ac6c: posts the ante 180
Hero: posts the ante 180
8638c512: posts the ante 180
e13e3da1: posts the ante 180
d7c2f8c8: posts the ante 180
58f968ce: posts the ante 180
Hero: posts small blind 600
d7c2f8c8: posts big blind 1,200
*** HOLE CARDS ***
Dealt to e13e3da1 
Dealt to 58f968ce 
Dealt to 880ac6c 
Dealt to Hero [3d 3h]
Dealt to d7c2f8c8 
Dealt to 8638c512 
8638c512: folds
e13e3da1: raises 1,440 to 2,640
58f968ce: folds
880ac6c: folds
Hero: calls 2,040
d7c2f8c8: folds
*** FLOP *** [4s 6h Qd]
Hero: checks
e13e3da1: bets 2,495
Hero: folds
Uncalled bet (2,495) returned to e13e3da1
*** SHOWDOWN ***
e13e3da1 collected 7,560 from pot
*** SUMMARY ***
Total pot 7,560 | Rake 0 | Jackpot 0 | Bingo 0 | Fortune 0 | Tax 0
Board [4s 6h Qd]
Seat 1: e13e3da1 won (7,560)
Seat 2: 58f968ce folded before Flop
Seat 3: 880ac6c (button) folded before Flop
Seat 4: Hero (small blind) folded on the Flop
Seat 5: d7c2f8c8 (big blind) folded before Flop
Seat 6: 8638c512 folded before Flop


Poker Hand #TM4180158771: Tournament #187165250, Mini Hypersonic $2.50 Hold'em No Limit - Level16(600/1,200) - 2025/02/03 16:52:28
Table '2' 6-max Seat #2 is the button
Seat 1: e13e3da1 (37,735 in chips)
Seat 2: 58f968ce (7,840 in chips)
Seat 3: 880ac6c (11,590 in chips)
Seat 4: Hero (23,957 in chips)
Seat 5: d7c2f8c8 (24,063 in chips)
Seat 6: 8638c512 (11,794 in chips)
880ac6c: posts the ante 180
Hero: posts the ante 180
8638c512: posts the ante 180
e13e3da1: posts the ante 180
d7c2f8c8: posts the ante 180
58f968ce: posts the ante 180
880ac6c: posts small blind 600
Hero: posts big blind 1,200
*** HOLE CARDS ***
Dealt to e13e3da1 
Dealt to 58f968ce 
Dealt to 880ac6c 
Dealt to Hero [6h 7d]
Dealt to d7c2f8c8 
Dealt to 8638c512 
d7c2f8c8: folds
8638c512: folds
e13e3da1: folds
58f968ce: raises 6,460 to 7,660 and is all-in
880ac6c: folds
Hero: folds
Uncalled bet (6,460) returned to 58f968ce
*** SHOWDOWN ***
58f968ce collected 4,080 from pot
*** SUMMARY ***
Total pot 4,080 | Rake 0 | Jackpot 0 | Bingo 0 | Fortune 0 | Tax 0
Seat 1: e13e3da1 folded before Flop
Seat 2: 58f968ce (button) collected (4,080)
Seat 3: 880ac6c (small blind) folded before Flop
Seat 4: Hero (big blind) folded before Flop
Seat 5: d7c2f8c8 folded before Flop
Seat 6: 8638c512 folded before Flop


Poker Hand #TM4180158762: Tournament #187165250, Mini Hypersonic $2.50 Hold'em No Limit - Level16(600/1,200) - 2025/02/03 16:51:43
Table '2' 6-max Seat #1 is the button
Seat 1: e13e3da1 (37,915 in chips)
Seat 2: 58f968ce (8,620 in chips)
Seat 3: 880ac6c (7,690 in chips)
Seat 4: Hero (26,537 in chips)
Seat 5: d7c2f8c8 (24,243 in chips)
Seat 6: 8638c512 (11,974 in chips)
880ac6c: posts the ante 180
Hero: posts the ante 180
8638c512: posts the ante 180
e13e3da1: posts the ante 180
d7c2f8c8: posts the ante 180
58f968ce: posts the ante 180
58f968ce: posts small blind 600
880ac6c: posts big blind 1,200
*** HOLE CARDS ***
Dealt to e13e3da1 
Dealt to 58f968ce 
Dealt to 880ac6c 
Dealt to Hero [Ts Kc]
Dealt to d7c2f8c8 
Dealt to 8638c512 
Hero: raises 1,200 to 2,400
d7c2f8c8: folds
8638c512: folds
e13e3da1: folds
58f968ce: folds
880ac6c: raises 5,110 to 7,510 and is all-in
Hero: folds
Uncalled bet (5,110) returned to 880ac6c
*** SHOWDOWN ***
880ac6c collected 6,480 from pot
*** SUMMARY ***
Total pot 6,480 | Rake 0 | Jackpot 0 | Bingo 0 | Fortune 0 | Tax 0
Seat 1: e13e3da1 (button) folded before Flop
Seat 2: 58f968ce (small blind) folded before Flop
Seat 3: 880ac6c (big blind) collected (6,480)
Seat 4: Hero folded before Flop
Seat 5: d7c2f8c8 folded before Flop
Seat 6: 8638c512 folded before Flop


Poker Hand #TM4180158752: Tournament #187165250, Mini Hypersonic $2.50 Hold'em No Limit - Level16(600/1,200) - 2025/02/03 16:51:12
Table '2' 6-max Seat #6 is the button
Seat 1: e13e3da1 (38,695 in chips)
Seat 2: 58f968ce (10,000 in chips)
Seat 3: 880ac6c (7,870 in chips)
Seat 4: Hero (26,717 in chips)
Seat 5: d7c2f8c8 (24,423 in chips)
Seat 6: 8638c512 (9,274 in chips)
880ac6c: posts the ante 180
Hero: posts the ante 180
8638c512: posts the ante 180
d7c2f8c8: posts the ante 180
e13e3da1: posts the ante 180
58f968ce: posts the ante 180
e13e3da1: posts small blind 600
58f968ce: posts big blind 1,200
*** HOLE CARDS ***
Dealt to e13e3da1 
Dealt to 58f968ce 
Dealt to 880ac6c 
Dealt to Hero [Kc 9h]
Dealt to d7c2f8c8 
Dealt to 8638c512 
880ac6c: folds
Hero: folds
d7c2f8c8: folds
8638c512: raises 7,894 to 9,094 and is all-in
e13e3da1: folds
58f968ce: folds
Uncalled bet (7,894) returned to 8638c512
*** SHOWDOWN ***
8638c512 collected 4,080 from pot
*** SUMMARY ***
Total pot 4,080 | Rake 0 | Jackpot 0 | Bingo 0 | Fortune 0 | Tax 0
Seat 1: e13e3da1 (small blind) folded before Flop
Seat 2: 58f968ce (big blind) folded before Flop
Seat 3: 880ac6c folded before Flop
Seat 4: Hero folded before Flop
Seat 5: d7c2f8c8 folded before Flop
Seat 6: 8638c512 (button) collected (4,080)


Poker Hand #TM4180158732: Tournament #187165250, Mini Hypersonic $2.50 Hold'em No Limit - Level15(500/1,000) - 2025/02/03 16:49:50
Table '2' 6-max Seat #5 is the button
Seat 1: e13e3da1 (33,862 in chips)
Seat 3: 880ac6c (8,020 in chips)
Seat 4: Hero (26,867 in chips)
Seat 5: d7c2f8c8 (28,306 in chips)
Seat 6: 8638c512 (9,924 in chips)
880ac6c: posts the ante 150
Hero: posts the ante 150
8638c512: posts the ante 150
d7c2f8c8: posts the ante 150
e13e3da1: posts the ante 150
8638c512: posts small blind 500
e13e3da1: posts big blind 1,000
*** HOLE CARDS ***
Dealt to e13e3da1 
Dealt to 880ac6c 
Dealt to Hero [2c Jc]
Dealt to d7c2f8c8 
Dealt to 8638c512 
880ac6c: folds
Hero: folds
d7c2f8c8: raises 1,000 to 2,000
8638c512: folds
e13e3da1: calls 1,000
*** FLOP *** [5h Jh As]
e13e3da1: checks
d7c2f8c8: checks
*** TURN *** [5h Jh As] [2d]
e13e3da1: checks
d7c2f8c8: bets 1,733
e13e3da1: calls 1,733
*** RIVER *** [5h Jh As 2d] [4d]
e13e3da1: bets 7,537
d7c2f8c8: folds
Uncalled bet (7,537) returned to e13e3da1
*** SHOWDOWN ***
e13e3da1 collected 8,716 from pot
*** SUMMARY ***
Total pot 8,716 | Rake 0 | Jackpot 0 | Bingo 0 | Fortune 0 | Tax 0
Board [5h Jh As 2d 4d]
Seat 1: e13e3da1 (big blind) showed [Ks] and won (8,716)
Seat 3: 880ac6c folded before Flop
Seat 4: Hero folded before Flop
Seat 5: d7c2f8c8 (button) folded on the River
Seat 6: 8638c512 (small blind) folded before Flop


Poker Hand #TM4180158729: Tournament #187165250, Mini Hypersonic $2.50 Hold'em No Limit - Level15(500/1,000) - 2025/02/03 16:49:36
Table '2' 6-max Seat #4 is the button
Seat 1: e13e3da1 (34,012 in chips)
Seat 3: 880ac6c (8,170 in chips)
Seat 4: Hero (27,017 in chips)
Seat 5: d7c2f8c8 (28,956 in chips)
Seat 6: 8638c512 (8,824 in chips)
880ac6c: posts the ante 150
Hero: posts the ante 150
8638c512: posts the ante 150
e13e3da1: posts the ante 150
d7c2f8c8: posts the ante 150
d7c2f8c8: posts small blind 500
8638c512: posts big blind 1,000
*** HOLE CARDS ***
Dealt to e13e3da1 
Dealt to 880ac6c 
Dealt to Hero [Ts 4s]
Dealt to d7c2f8c8 
Dealt to 8638c512 
e13e3da1: folds
880ac6c: folds
Hero: folds
d7c2f8c8: folds
Uncalled bet (500) returned to 8638c512
*** SHOWDOWN ***
8638c512 collected 1,750 from pot
*** SUMMARY ***
Total pot 1,750 | Rake 0 | Jackpot 0 | Bingo 0 | Fortune 0 | Tax 0
Seat 1: e13e3da1 folded before Flop
Seat 3: 880ac6c folded before Flop
Seat 4: Hero (button) folded before Flop
Seat 5: d7c2f8c8 (small blind) folded before Flop
Seat 6: 8638c512 (big blind) collected (1,750)


Poker Hand #TM4180158706: Tournament #187165250, Mini Hypersonic $2.50 Hold'em No Limit - Level15(500/1,000) - 2025/02/03 16:48:14
Table '2' 6-max Seat #3 is the button
Seat 1: e13e3da1 (34,162 in chips)
Seat 2: 148c23ae (14,153 in chips)
Seat 3: 880ac6c (8,320 in chips)
Seat 4: Hero (33,617 in chips)
Seat 5: d7c2f8c8 (21,756 in chips)
Seat 6: 8638c512 (8,974 in chips)
880ac6c: posts the ante 150
Hero: posts the ante 150
8638c512: posts the ante 150
148c23ae: posts the ante 150
e13e3da1: posts the ante 150
d7c2f8c8: posts the ante 150
Hero: posts small blind 500
d7c2f8c8: posts big blind 1,000
*** HOLE CARDS ***
Dealt to e13e3da1 
Dealt to 148c23ae 
Dealt to 880ac6c 
Dealt to Hero [Kc 7c]
Dealt to d7c2f8c8 
Dealt to 8638c512 
8638c512: folds
e13e3da1: folds
148c23ae: folds
880ac6c: folds
Hero: calls 500
d7c2f8c8: raises 2,000 to 3,000
Hero: calls 2,000
*** FLOP *** [8s 9h 7s]
Hero: checks
d7c2f8c8: bets 3,450
Hero: calls 3,450
*** TURN *** [8s 9h 7s] [6s]
Hero: checks
d7c2f8c8: bets 15,156 and is all-in
Hero: folds
Uncalled bet (15,156) returned to d7c2f8c8
*** SHOWDOWN ***
d7c2f8c8 collected 13,800 from pot
*** SUMMARY ***
Total pot 13,800 | Rake 0 | Jackpot 0 | Bingo 0 | Fortune 0 | Tax 0
Board [8s 9h 7s 6s]
Seat 1: e13e3da1 folded before Flop
Seat 2: 148c23ae folded before Flop
Seat 3: 880ac6c (button) folded before Flop
Seat 4: Hero (small blind) folded on the Turn
Seat 5: d7c2f8c8 (big blind) won (13,800)
Seat 6: 8638c512 folded before Flop


Poker Hand #TM4180158699: Tournament #187165250, Mini Hypersonic $2.50 Hold'em No Limit - Level15(500/1,000) - 2025/02/03 16:47:29
Table '2' 6-max Seat #2 is the button
Seat 1: e13e3da1 (30,712 in chips)
Seat 2: 148c23ae (14,303 in chips)
Seat 3: 880ac6c (8,970 in chips)
Seat 4: Hero (35,967 in chips)
Seat 5: d7c2f8c8 (21,906 in chips)
Seat 6: 8638c512 (9,124 in chips)
880ac6c: posts the ante 150
Hero: posts the ante 150
8638c512: posts the ante 150
148c23ae: posts the ante 150
e13e3da1: posts the ante 150
d7c2f8c8: posts the ante 150
880ac6c: posts small blind 500
Hero: posts big blind 1,000
*** HOLE CARDS ***
Dealt to e13e3da1 
Dealt to 148c23ae 
Dealt to 880ac6c 
Dealt to Hero [Qc 4c]
Dealt to d7c2f8c8 
Dealt to 8638c512 
d7c2f8c8: folds
8638c512: folds
e13e3da1: raises 1,200 to 2,200
148c23ae: folds
880ac6c: folds
Hero: calls 1,200
*** FLOP *** [9c 7s Ks]
Hero: checks
e13e3da1: bets 1,914
Hero: folds
Uncalled bet (1,914) returned to e13e3da1
*** SHOWDOWN ***
e13e3da1 collected 5,800 from pot
*** SUMMARY ***
Total pot 5,800 | Rake 0 | Jackpot 0 | Bingo 0 | Fortune 0 | Tax 0
Board [9c 7s Ks]
Seat 1: e13e3da1 won (5,800)
Seat 2: 148c23ae (button) folded before Flop
Seat 3: 880ac6c (small blind) folded before Flop
Seat 4: Hero (big blind) folded on the Flop
Seat 5: d7c2f8c8 folded before Flop
Seat 6: 8638c512 folded before Flop


Poker Hand #TM4180158692: Tournament #187165250, Mini Hypersonic $2.50 Hold'em No Limit - Level15(500/1,000) - 2025/02/03 16:47:11
Table '2' 6-max Seat #1 is the button
Seat 1: e13e3da1 (28,462 in chips)
Seat 2: 148c23ae (14,953 in chips)
Seat 3: 880ac6c (10,120 in chips)
Seat 4: Hero (36,117 in chips)
Seat 5: d7c2f8c8 (22,056 in chips)
Seat 6: 8638c512 (9,274 in chips)
880ac6c: posts the ante 150
Hero: posts the ante 150
8638c512: posts the ante 150
148c23ae: posts the ante 150
e13e3da1: posts the ante 150
d7c2f8c8: posts the ante 150
148c23ae: posts small blind 500
880ac6c: posts big blind 1,000
*** HOLE CARDS ***
Dealt to e13e3da1 
Dealt to 148c23ae 
Dealt to 880ac6c 
Dealt to Hero [9s 2s]
Dealt to d7c2f8c8 
Dealt to 8638c512 
Hero: folds
d7c2f8c8: folds
8638c512: folds
e13e3da1: raises 27,312 to 28,312 and is all-in
148c23ae: folds
880ac6c: folds
Uncalled bet (27,312) returned to e13e3da1
*** SHOWDOWN ***
e13e3da1 collected 3,400 from pot
*** SUMMARY ***
Total pot 3,400 | Rake 0 | Jackpot 0 | Bingo 0 | Fortune 0 | Tax 0
Seat 1: e13e3da1 (button) collected (3,400)
Seat 2: 148c23ae (small blind) folded before Flop
Seat 3: 880ac6c (big blind) folded before Flop
Seat 4: Hero folded before Flop
Seat 5: d7c2f8c8 folded before Flop
Seat 6: 8638c512 folded before Flop


Poker Hand #TM4180158686: Tournament #187165250, Mini Hypersonic $2.50 Hold'em No Limit - Level14(400/800) - 2025/02/03 16:46:57
Table '2' 6-max Seat #6 is the button
Seat 1: e13e3da1 (28,982 in chips)
Seat 2: 148c23ae (13,953 in chips)
Seat 3: 880ac6c (10,240 in chips)
Seat 4: Hero (36,237 in chips)
Seat 5: d7c2f8c8 (22,176 in chips)
Seat 6: 8638c512 (9,394 in chips)
880ac6c: posts the ante 120
Hero: posts the ante 120
8638c512: posts the ante 120
148c23ae: posts the ante 120
d7c2f8c8: posts the ante 120
e13e3da1: posts the ante 120
e13e3da1: posts small blind 400
148c23ae: posts big blind 800
*** HOLE CARDS ***
Dealt to e13e3da1 
Dealt to 148c23ae 
Dealt to 880ac6c 
Dealt to Hero [9s Kc]
Dealt to d7c2f8c8 
Dealt to 8638c512 
880ac6c: folds
Hero: folds
d7c2f8c8: folds
8638c512: folds
e13e3da1: folds
Uncalled bet (400) returned to 148c23ae
*** SHOWDOWN ***
148c23ae collected 1,520 from pot
*** SUMMARY ***
Total pot 1,520 | Rake 0 | Jackpot 0 | Bingo 0 | Fortune 0 | Tax 0
Seat 1: e13e3da1 (small blind) folded before Flop
Seat 2: 148c23ae (big blind) collected (1,520)
Seat 3: 880ac6c folded before Flop
Seat 4: Hero folded before Flop
Seat 5: d7c2f8c8 folded before Flop
Seat 6: 8638c512 (button) folded before Flop


Poker Hand #TM4180158680: Tournament #187165250, Mini Hypersonic $2.50 Hold'em No Limit - Level14(400/800) - 2025/02/03 16:46:21
Table '2' 6-max Seat #5 is the button
Seat 1: e13e3da1 (30,702 in chips)
Seat 2: 148c23ae (14,073 in chips)
Seat 3: 880ac6c (10,360 in chips)
Seat 4: Hero (36,357 in chips)
Seat 5: d7c2f8c8 (19,576 in chips)
Seat 6: 8638c512 (9,914 in chips)
880ac6c: posts the ante 120
Hero: posts the ante 120
8638c512: posts the ante 120
148c23ae: posts the ante 120
d7c2f8c8: posts the ante 120
e13e3da1: posts the ante 120
8638c512: posts small blind 400
e13e3da1: posts big blind 800
*** HOLE CARDS ***
Dealt to e13e3da1 
Dealt to 148c23ae 
Dealt to 880ac6c 
Dealt to Hero [4d 3c]
Dealt to d7c2f8c8 
Dealt to 8638c512 
148c23ae: folds
880ac6c: folds
Hero: folds
d7c2f8c8: raises 800 to 1,600
8638c512: folds
e13e3da1: calls 800
*** FLOP *** [Kh Kd 2c]
e13e3da1: checks
d7c2f8c8: bets 1,426
e13e3da1: folds
Uncalled bet (1,426) returned to d7c2f8c8
*** SHOWDOWN ***
d7c2f8c8 collected 4,320 from pot
*** SUMMARY ***
Total pot 4,320 | Rake 0 | Jackpot 0 | Bingo 0 | Fortune 0 | Tax 0
Board [Kh Kd 2c]
Seat 1: e13e3da1 (big blind) folded on the Flop
Seat 2: 148c23ae folded before Flop
Seat 3: 880ac6c folded before Flop
Seat 4: Hero folded before Flop
Seat 5: d7c2f8c8 (button) won (4,320)
Seat 6: 8638c512 (small blind) folded before Flop


Poker Hand #TM4180158657: Tournament #187165250, Mini Hypersonic $2.50 Hold'em No Limit - Level14(400/800) - 2025/02/03 16:44:35
Table '2' 6-max Seat #4 is the button
Seat 1: e13e3da1 (14,711 in chips)
Seat 2: 148c23ae (14,193 in chips)
Seat 3: 880ac6c (10,480 in chips)
Seat 4: Hero (36,477 in chips)
Seat 5: d7c2f8c8 (20,496 in chips)
Seat 6: 8638c512 (24,625 in chips)
880ac6c: posts the ante 120
Hero: posts the ante 120
8638c512: posts the ante 120
148c23ae: posts the ante 120
e13e3da1: posts the ante 120
d7c2f8c8: posts the ante 120
d7c2f8c8: posts small blind 400
8638c512: posts big blind 800
*** HOLE CARDS ***
Dealt to e13e3da1 
Dealt to 148c23ae 
Dealt to 880ac6c 
Dealt to Hero [2d Jh]
Dealt to d7c2f8c8 
Dealt to 8638c512 
e13e3da1: calls 800
148c23ae: folds
880ac6c: folds
Hero: folds
d7c2f8c8: calls 400
8638c512: checks
*** FLOP *** [Js 2h 5s]
d7c2f8c8: checks
8638c512: checks
e13e3da1: checks
*** TURN *** [Js 2h 5s] [7s]
d7c2f8c8: checks
8638c512: bets 2,340
e13e3da1: calls 2,340
d7c2f8c8: folds
*** RIVER *** [Js 2h 5s 7s] [3c]
8638c512: bets 20,800
e13e3da1: calls 11,451 and is all-in
Uncalled bet (9,349) returned to 8638c512
8638c512: shows [8c 9c] (Jack-High)
e13e3da1: shows [9d 7d] (Pair of Sevens)
*** SHOWDOWN ***
e13e3da1 collected 30,702 from pot
*** SUMMARY ***
Total pot 30,702 | Rake 0 | Jackpot 0 | Bingo 0 | Fortune 0 | Tax 0
Board [Js 2h 5s 7s 3c]
Seat 1: e13e3da1 showed [9d 7d] and won (30,702) with Pair of Sevens
Seat 2: 148c23ae folded before Flop
Seat 3: 880ac6c folded before Flop
Seat 4: Hero (button) folded before Flop
Seat 5: d7c2f8c8 (small blind) folded on the Turn
Seat 6: 8638c512 (big blind) showed [8c 9c] and lost with Jack-High


Poker Hand #TM4180158640: Tournament #187165250, Mini Hypersonic $2.50 Hold'em No Limit - Level14(400/800) - 2025/02/03 16:43:34
Table '2' 6-max Seat #3 is the button
Seat 1: e13e3da1 (14,831 in chips)
Seat 2: 148c23ae (14,313 in chips)
Seat 3: 880ac6c (10,600 in chips)
Seat 4: Hero (32,357 in chips)
Seat 5: d7c2f8c8 (22,376 in chips)
Seat 6: 8638c512 (26,505 in chips)
880ac6c: posts the ante 120
Hero: posts the ante 120
8638c512: posts the ante 120
148c23ae: posts the ante 120
e13e3da1: posts the ante 120
d7c2f8c8: posts the ante 120
Hero: posts small blind 400
d7c2f8c8: posts big blind 800
*** HOLE CARDS ***
Dealt to e13e3da1 
Dealt to 148c23ae 
Dealt to 880ac6c 
Dealt to Hero [Kd Qs]
Dealt to d7c2f8c8 
Dealt to 8638c512 
8638c512: raises 960 to 1,760
e13e3da1: folds
148c23ae: folds
880ac6c: folds
Hero: calls 1,360
d7c2f8c8: calls 960
*** FLOP *** [7s 9c 4d]
Hero: checks
d7c2f8c8: checks
8638c512: checks
*** TURN *** [7s 9c 4d] [Jh]
Hero: checks
d7c2f8c8: checks
8638c512: checks
*** RIVER *** [7s 9c 4d Jh] [Kh]
Hero: bets 3,200
d7c2f8c8: folds
8638c512: folds
Uncalled bet (3,200) returned to Hero
*** SHOWDOWN ***
Hero collected 6,000 from pot
*** SUMMARY ***
Total pot 6,000 | Rake 0 | Jackpot 0 | Bingo 0 | Fortune 0 | Tax 0
Board [7s 9c 4d Jh Kh]
Seat 1: e13e3da1 folded before Flop
Seat 2: 148c23ae folded before Flop
Seat 3: 880ac6c (button) folded before Flop
Seat 4: Hero (small blind) won (6,000)
Seat 5: d7c2f8c8 (big blind) folded on the River
Seat 6: 8638c512 folded on the River


Poker Hand #TM4180158636: Tournament #187165250, Mini Hypersonic $2.50 Hold'em No Limit - Level14(400/800) - 2025/02/03 16:43:14
Table '2' 6-max Seat #2 is the button
Seat 1: e13e3da1 (14,951 in chips)
Seat 2: 148c23ae (14,433 in chips)
Seat 3: 880ac6c (9,200 in chips)
Seat 4: Hero (33,277 in chips)
Seat 5: d7c2f8c8 (22,496 in chips)
Seat 6: 8638c512 (26,625 in chips)
880ac6c: posts the ante 120
Hero: posts the ante 120
8638c512: posts the ante 120
148c23ae: posts the ante 120
e13e3da1: posts the ante 120
d7c2f8c8: posts the ante 120
880ac6c: posts small blind 400
Hero: posts big blind 800
*** HOLE CARDS ***
Dealt to e13e3da1 
Dealt to 148c23ae 
Dealt to 880ac6c 
Dealt to Hero [6c 3c]
Dealt to d7c2f8c8 
Dealt to 8638c512 
d7c2f8c8: folds
8638c512: folds
e13e3da1: folds
148c23ae: folds
880ac6c: raises 8,280 to 9,080 and is all-in
Hero: folds
Uncalled bet (8,280) returned to 880ac6c
*** SHOWDOWN ***
880ac6c collected 2,320 from pot
*** SUMMARY ***
Total pot 2,320 | Rake 0 | Jackpot 0 | Bingo 0 | Fortune 0 | Tax 0
Seat 1: e13e3da1 folded before Flop
Seat 2: 148c23ae (button) folded before Flop
Seat 3: 880ac6c (small blind) collected (2,320)
Seat 4: Hero (big blind) folded before Flop
Seat 5: d7c2f8c8 folded before Flop
Seat 6: 8638c512 folded before Flop


Poker Hand #TM4180158629: Tournament #187165250, Mini Hypersonic $2.50 Hold'em No Limit - Level13(350/700) - 2025/02/03 16:42:54
Table '2' 6-max Seat #1 is the button
Seat 1: e13e3da1 (15,051 in chips)
Seat 2: 148c23ae (13,233 in chips)
Seat 3: 880ac6c (10,000 in chips)
Seat 4: Hero (33,377 in chips)
Seat 5: d7c2f8c8 (22,596 in chips)
Seat 6: 8638c512 (26,725 in chips)
880ac6c: posts the ante 100
Hero: posts the ante 100
8638c512: posts the ante 100
148c23ae: posts the ante 100
e13e3da1: posts the ante 100
d7c2f8c8: posts the ante 100
148c23ae: posts small blind 350
880ac6c: posts big blind 700
*** HOLE CARDS ***
Dealt to e13e3da1 
Dealt to 148c23ae 
Dealt to 880ac6c 
Dealt to Hero [4s 6c]
Dealt to d7c2f8c8 
Dealt to 8638c512 
Hero: folds
d7c2f8c8: folds
8638c512: folds
e13e3da1: folds
148c23ae: raises 12,433 to 13,133 and is all-in
880ac6c: folds
Uncalled bet (12,433) returned to 148c23ae
*** SHOWDOWN ***
148c23ae collected 2,000 from pot
*** SUMMARY ***
Total pot 2,000 | Rake 0 | Jackpot 0 | Bingo 0 | Fortune 0 | Tax 0
Seat 1: e13e3da1 (button) folded before Flop
Seat 2: 148c23ae (small blind) collected (2,000)
Seat 3: 880ac6c (big blind) folded before Flop
Seat 4: Hero folded before Flop
Seat 5: d7c2f8c8 folded before Flop
Seat 6: 8638c512 folded before Flop


Poker Hand #TM4180158619: Tournament #187165250, Mini Hypersonic $2.50 Hold'em No Limit - Level13(350/700) - 2025/02/03 16:42:09
Table '2' 6-max Seat #6 is the button
Seat 1: e13e3da1 (15,501 in chips)
Seat 2: 148c23ae (14,033 in chips)
Seat 3: 62a1d8c0 (15,165 in chips)
Seat 4: Hero (16,762 in chips)
Seat 5: d7c2f8c8 (22,696 in chips)
Seat 6: 8638c512 (26,825 in chips)
Hero: posts the ante 100
8638c512: posts the ante 100
148c23ae: posts the ante 100
62a1d8c0: posts the ante 100
d7c2f8c8: posts the ante 100
e13e3da1: posts the ante 100
e13e3da1: posts small blind 350
148c23ae: posts big blind 700
*** HOLE CARDS ***
Dealt to e13e3da1 
Dealt to 148c23ae 
Dealt to 62a1d8c0 
Dealt to Hero [Ad As]
Dealt to d7c2f8c8 
Dealt to 8638c512 
62a1d8c0: raises 700 to 1,400
Hero: raises 2,100 to 3,500
d7c2f8c8: folds
8638c512: folds
e13e3da1: folds
148c23ae: folds
62a1d8c0: raises 11,565 to 15,065 and is all-in
Hero: calls 11,565
62a1d8c0: shows [Ah Qh]
Hero: shows [Ad As]
*** FLOP *** [3s 2s 6s]
*** TURN *** [3s 2s 6s] [Jd]
*** RIVER *** [3s 2s 6s Jd] [5s]
*** SHOWDOWN ***
Hero collected 31,780 from pot
*** SUMMARY ***
Total pot 31,780 | Rake 0 | Jackpot 0 | Bingo 0 | Fortune 0 | Tax 0
Board [3s 2s 6s Jd 5s]
Seat 1: e13e3da1 (small blind) folded before Flop
Seat 2: 148c23ae (big blind) folded before Flop
Seat 3: 62a1d8c0 showed [Ah Qh] and lost with Ace-High
Seat 4: Hero showed [Ad As] and won (31,780) with Ace High Flush
Seat 5: d7c2f8c8 folded before Flop
Seat 6: 8638c512 (button) folded before Flop


Poker Hand #TM4180158608: Tournament #187165250, Mini Hypersonic $2.50 Hold'em No Limit - Level13(350/700) - 2025/02/03 16:41:38
Table '2' 6-max Seat #5 is the button
Seat 1: e13e3da1 (16,301 in chips)
Seat 2: 148c23ae (14,133 in chips)
Seat 3: 62a1d8c0 (15,265 in chips)
Seat 4: Hero (15,212 in chips)
Seat 5: d7c2f8c8 (22,796 in chips)
Seat 6: 8638c512 (27,275 in chips)
Hero: posts the ante 100
8638c512: posts the ante 100
148c23ae: posts the ante 100
62a1d8c0: posts the ante 100
d7c2f8c8: posts the ante 100
e13e3da1: posts the ante 100
8638c512: posts small blind 350
e13e3da1: posts big blind 700
*** HOLE CARDS ***
Dealt to e13e3da1 
Dealt to 148c23ae 
Dealt to 62a1d8c0 
Dealt to Hero [Ks Qs]
Dealt to d7c2f8c8 
Dealt to 8638c512 
148c23ae: folds
62a1d8c0: folds
Hero: raises 700 to 1,400
d7c2f8c8: folds
8638c512: folds
e13e3da1: folds
Uncalled bet (700) returned to Hero
*** SHOWDOWN ***
Hero collected 2,350 from pot
*** SUMMARY ***
Total pot 2,350 | Rake 0 | Jackpot 0 | Bingo 0 | Fortune 0 | Tax 0
Seat 1: e13e3da1 (big blind) folded before Flop
Seat 2: 148c23ae folded before Flop
Seat 3: 62a1d8c0 folded before Flop
Seat 4: Hero collected (2,350)
Seat 5: d7c2f8c8 (button) folded before Flop
Seat 6: 8638c512 (small blind) folded before Flop


Poker Hand #TM4180158585: Tournament #187165250, Mini Hypersonic $2.50 Hold'em No Limit - Level13(350/700) - 2025/02/03 16:40:22
Table '2' 6-max Seat #4 is the button
Seat 1: e13e3da1 (22,879 in chips)
Seat 2: 148c23ae (14,233 in chips)
Seat 3: 62a1d8c0 (15,365 in chips)
Seat 4: Hero (15,312 in chips)
Seat 5: d7c2f8c8 (23,246 in chips)
Seat 6: 8638c512 (19,947 in chips)
Hero: posts the ante 100
8638c512: posts the ante 100
148c23ae: posts the ante 100
62a1d8c0: posts the ante 100
e13e3da1: posts the ante 100
d7c2f8c8: posts the ante 100
d7c2f8c8: posts small blind 350
8638c512: posts big blind 700
*** HOLE CARDS ***
Dealt to e13e3da1 
Dealt to 148c23ae 
Dealt to 62a1d8c0 
Dealt to Hero [3h 9h]
Dealt to d7c2f8c8 
Dealt to 8638c512 
e13e3da1: raises 840 to 1,540
148c23ae: folds
62a1d8c0: folds
Hero: folds
d7c2f8c8: folds
8638c512: calls 840
*** FLOP *** [Kh Kd 2c]
8638c512: checks
e13e3da1: bets 1,330
8638c512: calls 1,330
*** TURN *** [Kh Kd 2c] [4c]
8638c512: checks
e13e3da1: bets 3,608
8638c512: calls 3,608
*** RIVER *** [Kh Kd 2c 4c] [Ad]
8638c512: checks
e13e3da1: checks
8638c512: shows [Kc Th] (Three Kings)
e13e3da1: shows [Ts Tc] (Pair of Kings and Pair of Tens)
*** SHOWDOWN ***
8638c512 collected 13,906 from pot
*** SUMMARY ***
Total pot 13,906 | Rake 0 | Jackpot 0 | Bingo 0 | Fortune 0 | Tax 0
Board [Kh Kd 2c 4c Ad]
Seat 1: e13e3da1 showed [Ts Tc] and lost with Pair of Kings and Pair of Tens
Seat 2: 148c23ae folded before Flop
Seat 3: 62a1d8c0 folded before Flop
Seat 4: Hero (button) folded before Flop
Seat 5: d7c2f8c8 (small blind) folded before Flop
Seat 6: 8638c512 (big blind) showed [Kc Th] and won (13,906) with Three Kings


Poker Hand #TM4180158579: Tournament #187165250, Mini Hypersonic $2.50 Hold'em No Limit - Level13(350/700) - 2025/02/03 16:40:03
Table '2' 6-max Seat #3 is the button
Seat 1: e13e3da1 (22,979 in chips)
Seat 2: 148c23ae (12,683 in chips)
Seat 3: 62a1d8c0 (15,465 in chips)
Seat 4: Hero (15,762 in chips)
Seat 5: d7c2f8c8 (24,046 in chips)
Seat 6: 8638c512 (20,047 in chips)
Hero: posts the ante 100
8638c512: posts the ante 100
148c23ae: posts the ante 100
62a1d8c0: posts the ante 100
e13e3da1: posts the ante 100
d7c2f8c8: posts the ante 100
Hero: posts small blind 350
d7c2f8c8: posts big blind 700
*** HOLE CARDS ***
Dealt to e13e3da1 
Dealt to 148c23ae 
Dealt to 62a1d8c0 
Dealt to Hero [9h As]
Dealt to d7c2f8c8 
Dealt to 8638c512 
8638c512: folds
e13e3da1: folds
148c23ae: raises 11,883 to 12,583 and is all-in
62a1d8c0: folds
Hero: folds
d7c2f8c8: folds
Uncalled bet (11,883) returned to 148c23ae
*** SHOWDOWN ***
148c23ae collected 2,350 from pot
*** SUMMARY ***
Total pot 2,350 | Rake 0 | Jackpot 0 | Bingo 0 | Fortune 0 | Tax 0
Seat 1: e13e3da1 folded before Flop
Seat 2: 148c23ae collected (2,350)
Seat 3: 62a1d8c0 (button) folded before Flop
Seat 4: Hero (small blind) folded before Flop
Seat 5: d7c2f8c8 (big blind) folded before Flop
Seat 6: 8638c512 folded before Flop


Poker Hand #TM4180158560: Tournament #187165250, Mini Hypersonic $2.50 Hold'em No Limit - Level12(300/600) - 2025/02/03 16:38:53
Table '2' 6-max Seat #2 is the button
Seat 1: e13e3da1 (23,069 in chips)
Seat 2: 148c23ae (12,773 in chips)
Seat 3: 62a1d8c0 (15,855 in chips)
Seat 4: Hero (24,852 in chips)
Seat 5: d7c2f8c8 (14,296 in chips)
Seat 6: 8638c512 (20,137 in chips)
Hero: posts the ante 90
8638c512: posts the ante 90
148c23ae: posts the ante 90
62a1d8c0: posts the ante 90
e13e3da1: posts the ante 90
d7c2f8c8: posts the ante 90
62a1d8c0: posts small blind 300
Hero: posts big blind 600
*** HOLE CARDS ***
Dealt to e13e3da1 
Dealt to 148c23ae 
Dealt to 62a1d8c0 
Dealt to Hero [Qd Kc]
Dealt to d7c2f8c8 
Dealt to 8638c512 
d7c2f8c8: raises 600 to 1,200
8638c512: folds
e13e3da1: folds
148c23ae: folds
62a1d8c0: folds
Hero: calls 600
*** FLOP *** [Qc 6c 7h]
Hero: checks
d7c2f8c8: bets 1,070
Hero: raises 1,930 to 3,000
d7c2f8c8: calls 1,930
*** TURN *** [Qc 6c 7h] [5c]
Hero: checks
d7c2f8c8: checks
*** RIVER *** [Qc 6c 7h 5c] [4s]
Hero: bets 4,800
d7c2f8c8: calls 4,800
Hero: shows [Qd Kc] (Pair of Queens)
d7c2f8c8: shows [8h Qh] (Eights-High Straight)
*** SHOWDOWN ***
d7c2f8c8 collected 18,840 from pot
*** SUMMARY ***
Total pot 18,840 | Rake 0 | Jackpot 0 | Bingo 0 | Fortune 0 | Tax 0
Board [Qc 6c 7h 5c 4s]
Seat 1: e13e3da1 folded before Flop
Seat 2: 148c23ae (button) folded before Flop
Seat 3: 62a1d8c0 (small blind) folded before Flop
Seat 4: Hero (big blind) showed [Qd Kc] and lost with Pair of Queens
Seat 5: d7c2f8c8 showed [8h Qh] and won (18,840) with Eights-High Straight
Seat 6: 8638c512 folded before Flop


Poker Hand #TM4180158549: Tournament #187165250, Mini Hypersonic $2.50 Hold'em No Limit - Level12(300/600) - 2025/02/03 16:38:26
Table '2' 6-max Seat #1 is the button
Seat 1: e13e3da1 (21,719 in chips)
Seat 2: 148c23ae (13,163 in chips)
Seat 3: 62a1d8c0 (16,545 in chips)
Seat 4: Hero (24,942 in chips)
Seat 5: d7c2f8c8 (14,386 in chips)
Seat 6: 8638c512 (20,227 in chips)
Hero: posts the ante 90
8638c512: posts the ante 90
148c23ae: posts the ante 90
62a1d8c0: posts the ante 90
e13e3da1: posts the ante 90
d7c2f8c8: posts the ante 90
148c23ae: posts small blind 300
62a1d8c0: posts big blind 600
*** HOLE CARDS ***
Dealt to e13e3da1 
Dealt to 148c23ae 
Dealt to 62a1d8c0 
Dealt to Hero [9d 6s]
Dealt to d7c2f8c8 
Dealt to 8638c512 
Hero: folds
d7c2f8c8: folds
8638c512: folds
e13e3da1: raises 900 to 1,500
148c23ae: folds
62a1d8c0: folds
Uncalled bet (900) returned to e13e3da1
*** SHOWDOWN ***
e13e3da1 collected 2,040 from pot
*** SUMMARY ***
Total pot 2,040 | Rake 0 | Jackpot 0 | Bingo 0 | Fortune 0 | Tax 0
Seat 1: e13e3da1 (button) collected (2,040)
Seat 2: 148c23ae (small blind) folded before Flop
Seat 3: 62a1d8c0 (big blind) folded before Flop
Seat 4: Hero folded before Flop
Seat 5: d7c2f8c8 folded before Flop
Seat 6: 8638c512 folded before Flop


Poker Hand #TM4180158544: Tournament #187165250, Mini Hypersonic $2.50 Hold'em No Limit - Level12(300/600) - 2025/02/03 16:38:07
Table '2' 6-max Seat #6 is the button
Seat 1: e13e3da1 (22,109 in chips)
Seat 2: 148c23ae (13,853 in chips)
Seat 3: 62a1d8c0 (16,635 in chips)
Seat 4: Hero (25,032 in chips)
Seat 5: d7c2f8c8 (14,476 in chips)
Seat 6: 8638c512 (18,877 in chips)
Hero: posts the ante 90
8638c512: posts the ante 90
148c23ae: posts the ante 90
62a1d8c0: posts the ante 90
d7c2f8c8: posts the ante 90
e13e3da1: posts the ante 90
e13e3da1: posts small blind 300
148c23ae: posts big blind 600
*** HOLE CARDS ***
Dealt to e13e3da1 
Dealt to 148c23ae 
Dealt to 62a1d8c0 
Dealt to Hero [3s Kc]
Dealt to d7c2f8c8 
Dealt to 8638c512 
62a1d8c0: folds
Hero: folds
d7c2f8c8: folds
8638c512: raises 720 to 1,320
e13e3da1: folds
148c23ae: folds
Uncalled bet (720) returned to 8638c512
*** SHOWDOWN ***
8638c512 collected 2,040 from pot
*** SUMMARY ***
Total pot 2,040 | Rake 0 | Jackpot 0 | Bingo 0 | Fortune 0 | Tax 0
Seat 1: e13e3da1 (small blind) folded before Flop
Seat 2: 148c23ae (big blind) folded before Flop
Seat 3: 62a1d8c0 folded before Flop
Seat 4: Hero folded before Flop
Seat 5: d7c2f8c8 folded before Flop
Seat 6: 8638c512 (button) collected (2,040)


Poker Hand #TM4180158526: Tournament #187165250, Mini Hypersonic $2.50 Hold'em No Limit - Level12(300/600) - 2025/02/03 16:37:14
Table '2' 6-max Seat #5 is the button
Seat 1: e13e3da1 (23,399 in chips)
Seat 2: 148c23ae (13,943 in chips)
Seat 3: 62a1d8c0 (14,685 in chips)
Seat 4: Hero (25,122 in chips)
Seat 5: d7c2f8c8 (14,566 in chips)
Seat 6: 8638c512 (19,267 in chips)
Hero: posts the ante 90
8638c512: posts the ante 90
148c23ae: posts the ante 90
62a1d8c0: posts the ante 90
d7c2f8c8: posts the ante 90
e13e3da1: posts the ante 90
8638c512: posts small blind 300
e13e3da1: posts big blind 600
*** HOLE CARDS ***
Dealt to e13e3da1 
Dealt to 148c23ae 
Dealt to 62a1d8c0 
Dealt to Hero [Js 2d]
Dealt to d7c2f8c8 
Dealt to 8638c512 
148c23ae: folds
62a1d8c0: raises 600 to 1,200
Hero: folds
d7c2f8c8: folds
8638c512: folds
e13e3da1: calls 600
*** FLOP *** [Kc Ts 7h]
e13e3da1: checks
62a1d8c0: bets 1,200
e13e3da1: folds
Uncalled bet (1,200) returned to 62a1d8c0
*** SHOWDOWN ***
62a1d8c0 collected 3,240 from pot
*** SUMMARY ***
Total pot 3,240 | Rake 0 | Jackpot 0 | Bingo 0 | Fortune 0 | Tax 0
Board [Kc Ts 7h]
Seat 1: e13e3da1 (big blind) folded on the Flop
Seat 2: 148c23ae folded before Flop
Seat 3: 62a1d8c0 won (3,240)
Seat 4: Hero folded before Flop
Seat 5: d7c2f8c8 (button) folded before Flop
Seat 6: 8638c512 (small blind) folded before Flop


Poker Hand #TM4180158515: Tournament #187165250, Mini Hypersonic $2.50 Hold'em No Limit - Level12(300/600) - 2025/02/03 16:36:36
Table '2' 6-max Seat #4 is the button
Seat 1: e13e3da1 (23,489 in chips)
Seat 2: 148c23ae (14,033 in chips)
Seat 3: 62a1d8c0 (14,775 in chips)
Seat 4: Hero (25,212 in chips)
Seat 5: d7c2f8c8 (12,916 in chips)
Seat 6: 8638c512 (20,557 in chips)
Hero: posts the ante 90
8638c512: posts the ante 90
148c23ae: posts the ante 90
62a1d8c0: posts the ante 90
e13e3da1: posts the ante 90
d7c2f8c8: posts the ante 90
d7c2f8c8: posts small blind 300
8638c512: posts big blind 600
*** HOLE CARDS ***
Dealt to e13e3da1 
Dealt to 148c23ae 
Dealt to 62a1d8c0 
Dealt to Hero [5c Ks]
Dealt to d7c2f8c8 
Dealt to 8638c512 
e13e3da1: folds
148c23ae: folds
62a1d8c0: folds
Hero: folds
d7c2f8c8: calls 300
8638c512: checks
*** FLOP *** [Ac 7d Qs]
d7c2f8c8: bets 600
8638c512: calls 600
*** TURN *** [Ac 7d Qs] [9s]
d7c2f8c8: bets 2,070
8638c512: folds
Uncalled bet (2,070) returned to d7c2f8c8
*** SHOWDOWN ***
d7c2f8c8 collected 2,940 from pot
*** SUMMARY ***
Total pot 2,940 | Rake 0 | Jackpot 0 | Bingo 0 | Fortune 0 | Tax 0
Board [Ac 7d Qs 9s]
Seat 1: e13e3da1 folded before Flop
Seat 2: 148c23ae folded before Flop
Seat 3: 62a1d8c0 folded before Flop
Seat 4: Hero (button) folded before Flop
Seat 5: d7c2f8c8 (small blind) won (2,940)
Seat 6: 8638c512 (big blind) folded on the Turn


Poker Hand #TM4180158506: Tournament #187165250, Mini Hypersonic $2.50 Hold'em No Limit - Level12(300/600) - 2025/02/03 16:36:14
Table '2' 6-max Seat #3 is the button
Seat 1: e13e3da1 (23,579 in chips)
Seat 2: 148c23ae (15,323 in chips)
Seat 3: 62a1d8c0 (14,865 in chips)
Seat 4: Hero (22,962 in chips)
Seat 5: d7c2f8c8 (13,606 in chips)
Seat 6: 8638c512 (20,647 in chips)
Hero: posts the ante 90
8638c512: posts the ante 90
148c23ae: posts the ante 90
62a1d8c0: posts the ante 90
e13e3da1: posts the ante 90
d7c2f8c8: posts the ante 90
Hero: posts small blind 300
d7c2f8c8: posts big blind 600
*** HOLE CARDS ***
Dealt to e13e3da1 
Dealt to 148c23ae 
Dealt to 62a1d8c0 
Dealt to Hero [Kh Ad]
Dealt to d7c2f8c8 
Dealt to 8638c512 
8638c512: folds
e13e3da1: folds
148c23ae: raises 600 to 1,200
62a1d8c0: folds
Hero: raises 2,400 to 3,600
d7c2f8c8: folds
148c23ae: folds
Uncalled bet (2,400) returned to Hero
*** SHOWDOWN ***
Hero collected 3,540 from pot
*** SUMMARY ***
Total pot 3,540 | Rake 0 | Jackpot 0 | Bingo 0 | Fortune 0 | Tax 0
Seat 1: e13e3da1 folded before Flop
Seat 2: 148c23ae folded before Flop
Seat 3: 62a1d8c0 (button) folded before Flop
Seat 4: Hero (small blind) collected (3,540)
Seat 5: d7c2f8c8 (big blind) folded before Flop
Seat 6: 8638c512 folded before Flop


Poker Hand #TM4180158491: Tournament #187165250, Mini Hypersonic $2.50 Hold'em No Limit - Level12(300/600) - 2025/02/03 16:35:20
Table '2' 6-max Seat #2 is the button
Seat 1: e13e3da1 (23,669 in chips)
Seat 2: 148c23ae (17,980 in chips)
Seat 3: 62a1d8c0 (10,648 in chips)
Seat 4: Hero (24,252 in chips)
Seat 5: d7c2f8c8 (13,696 in chips)
Seat 6: 8638c512 (20,737 in chips)
Hero: posts the ante 90
8638c512: posts the ante 90
148c23ae: posts the ante 90
62a1d8c0: posts the ante 90
e13e3da1: posts the ante 90
d7c2f8c8: posts the ante 90
62a1d8c0: posts small blind 300
Hero: posts big blind 600
*** HOLE CARDS ***
Dealt to e13e3da1 
Dealt to 148c23ae 
Dealt to 62a1d8c0 
Dealt to Hero [9d Qs]
Dealt to d7c2f8c8 
Dealt to 8638c512 
d7c2f8c8: folds
8638c512: folds
e13e3da1: folds
148c23ae: raises 600 to 1,200
62a1d8c0: calls 900
Hero: calls 600
*** FLOP *** [7d 4s 6d]
62a1d8c0: checks
Hero: checks
148c23ae: bets 1,367
62a1d8c0: raises 2,833 to 4,200
Hero: folds
148c23ae: folds
Uncalled bet (2,833) returned to 62a1d8c0
*** SHOWDOWN ***
62a1d8c0 collected 6,874 from pot
*** SUMMARY ***
Total pot 6,874 | Rake 0 | Jackpot 0 | Bingo 0 | Fortune 0 | Tax 0
Board [7d 4s 6d]
Seat 1: e13e3da1 folded before Flop
Seat 2: 148c23ae (button) folded on the Flop
Seat 3: 62a1d8c0 (small blind) won (6,874)
Seat 4: Hero (big blind) folded on the Flop
Seat 5: d7c2f8c8 folded before Flop
Seat 6: 8638c512 folded before Flop


Poker Hand #TM4180158466: Tournament #187165250, Mini Hypersonic $2.50 Hold'em No Limit - Level11(250/500) - 2025/02/03 16:34:03
Table '2' 6-max Seat #1 is the button
Seat 1: e13e3da1 (23,744 in chips)
Seat 2: 148c23ae (18,305 in chips)
Seat 3: 62a1d8c0 (5,049 in chips)
Seat 4: Hero (24,327 in chips)
Seat 5: d7c2f8c8 (13,771 in chips)
Seat 6: 8638c512 (25,786 in chips)
Hero: posts the ante 75
8638c512: posts the ante 75
148c23ae: posts the ante 75
62a1d8c0: posts the ante 75
e13e3da1: posts the ante 75
d7c2f8c8: posts the ante 75
148c23ae: posts small blind 250
62a1d8c0: posts big blind 500
*** HOLE CARDS ***
Dealt to e13e3da1 
Dealt to 148c23ae 
Dealt to 62a1d8c0 
Dealt to Hero [8d 6h]
Dealt to d7c2f8c8 
Dealt to 8638c512 
Hero: folds
d7c2f8c8: folds
8638c512: raises 600 to 1,100
e13e3da1: folds
148c23ae: folds
62a1d8c0: calls 600
*** FLOP *** [Jd 4s 2h]
62a1d8c0: checks
8638c512: bets 725
62a1d8c0: raises 3,149 to 3,874 and is all-in
8638c512: calls 3,149
62a1d8c0: shows [Kh Jc] (Pair of Jacks)
8638c512: shows [Kc Qd] (King-High)
*** TURN *** [Jd 4s 2h] [4c]
*** RIVER *** [Jd 4s 2h 4c] [6d]
*** SHOWDOWN ***
62a1d8c0 collected 10,648 from pot
*** SUMMARY ***
Total pot 10,648 | Rake 0 | Jackpot 0 | Bingo 0 | Fortune 0 | Tax 0
Board [Jd 4s 2h 4c 6d]
Seat 1: e13e3da1 (button) folded before Flop
Seat 2: 148c23ae (small blind) folded before Flop
Seat 3: 62a1d8c0 (big blind) showed [Kh Jc] and won (10,648) with Pair of Jacks and Pair of Fours
Seat 4: Hero folded before Flop
Seat 5: d7c2f8c8 folded before Flop
Seat 6: 8638c512 showed [Kc Qd] and lost with Pair of Fours


Poker Hand #TM4180158459: Tournament #187165250, Mini Hypersonic $2.50 Hold'em No Limit - Level11(250/500) - 2025/02/03 16:33:32
Table '2' 6-max Seat #6 is the button
Seat 1: e13e3da1 (24,069 in chips)
Seat 2: 148c23ae (17,680 in chips)
Seat 3: 62a1d8c0 (5,124 in chips)
Seat 4: Hero (24,402 in chips)
Seat 5: d7c2f8c8 (13,846 in chips)
Seat 6: 8638c512 (25,861 in chips)
Hero: posts the ante 75
8638c512: posts the ante 75
148c23ae: posts the ante 75
62a1d8c0: posts the ante 75
d7c2f8c8: posts the ante 75
e13e3da1: posts the ante 75
e13e3da1: posts small blind 250
148c23ae: posts big blind 500
*** HOLE CARDS ***
Dealt to e13e3da1 
Dealt to 148c23ae 
Dealt to 62a1d8c0 
Dealt to Hero [Jc 5h]
Dealt to d7c2f8c8 
Dealt to 8638c512 
62a1d8c0: folds
Hero: folds
d7c2f8c8: folds
8638c512: folds
e13e3da1: folds
Uncalled bet (250) returned to 148c23ae
*** SHOWDOWN ***
148c23ae collected 950 from pot
*** SUMMARY ***
Total pot 950 | Rake 0 | Jackpot 0 | Bingo 0 | Fortune 0 | Tax 0
Seat 1: e13e3da1 (small blind) folded before Flop
Seat 2: 148c23ae (big blind) collected (950)
Seat 3: 62a1d8c0 folded before Flop
Seat 4: Hero folded before Flop
Seat 5: d7c2f8c8 folded before Flop
Seat 6: 8638c512 (button) folded before Flop


Poker Hand #TM4180158446: Tournament #187165250, Mini Hypersonic $2.50 Hold'em No Limit - Level11(250/500) - 2025/02/03 16:32:55
Table '2' 6-max Seat #5 is the button
Seat 1: e13e3da1 (25,144 in chips)
Seat 2: 148c23ae (17,755 in chips)
Seat 3: 62a1d8c0 (5,199 in chips)
Seat 4: Hero (22,777 in chips)
Seat 5: d7c2f8c8 (13,921 in chips)
Seat 6: 8638c512 (26,186 in chips)
Hero: posts the ante 75
8638c512: posts the ante 75
148c23ae: posts the ante 75
62a1d8c0: posts the ante 75
d7c2f8c8: posts the ante 75
e13e3da1: posts the ante 75
8638c512: posts small blind 250
e13e3da1: posts big blind 500
*** HOLE CARDS ***
Dealt to e13e3da1 
Dealt to 148c23ae 
Dealt to 62a1d8c0 
Dealt to Hero [8h Ac]
Dealt to d7c2f8c8 
Dealt to 8638c512 
148c23ae: folds
62a1d8c0: folds
Hero: raises 500 to 1,000
d7c2f8c8: folds
8638c512: folds
e13e3da1: calls 500
*** FLOP *** [4d 3d Ah]
e13e3da1: checks
Hero: bets 675
e13e3da1: folds
Uncalled bet (675) returned to Hero
*** SHOWDOWN ***
Hero collected 2,700 from pot
*** SUMMARY ***
Total pot 2,700 | Rake 0 | Jackpot 0 | Bingo 0 | Fortune 0 | Tax 0
Board [4d 3d Ah]
Seat 1: e13e3da1 (big blind) folded on the Flop
Seat 2: 148c23ae folded before Flop
Seat 3: 62a1d8c0 folded before Flop
Seat 4: Hero won (2,700)
Seat 5: d7c2f8c8 (button) folded before Flop
Seat 6: 8638c512 (small blind) folded before Flop


Poker Hand #TM4180158421: Tournament #187165250, Mini Hypersonic $2.50 Hold'em No Limit - Level11(250/500) - 2025/02/03 16:31:21
Table '2' 6-max Seat #4 is the button
Seat 1: e13e3da1 (27,219 in chips)
Seat 2: 148c23ae (17,830 in chips)
Seat 3: 62a1d8c0 (5,274 in chips)
Seat 4: Hero (19,652 in chips)
Seat 5: d7c2f8c8 (14,246 in chips)
Seat 6: 8638c512 (26,761 in chips)
Hero: posts the ante 75
8638c512: posts the ante 75
148c23ae: posts the ante 75
62a1d8c0: posts the ante 75
e13e3da1: posts the ante 75
d7c2f8c8: posts the ante 75
d7c2f8c8: posts small blind 250
8638c512: posts big blind 500
*** HOLE CARDS ***
Dealt to e13e3da1 
Dealt to 148c23ae 
Dealt to 62a1d8c0 
Dealt to Hero [Td Ts]
Dealt to d7c2f8c8 
Dealt to 8638c512 
e13e3da1: calls 500
148c23ae: folds
62a1d8c0: folds
Hero: raises 500 to 1,000
d7c2f8c8: folds
8638c512: folds
e13e3da1: calls 500
*** FLOP *** [Qh 4s Kc]
e13e3da1: checks
Hero: checks
*** TURN *** [Qh 4s Kc] [Ks]
e13e3da1: checks
Hero: bets 1,000
e13e3da1: calls 1,000
*** RIVER *** [Qh 4s Kc Ks] [Ac]
e13e3da1: checks
Hero: checks
e13e3da1: shows [5d 5s] (Pair of Kings and Pair of Fives)
Hero: shows [Td Ts] (Pair of Kings and Pair of Tens)
*** SHOWDOWN ***
Hero collected 5,200 from pot
*** SUMMARY ***
Total pot 5,200 | Rake 0 | Jackpot 0 | Bingo 0 | Fortune 0 | Tax 0
Board [Qh 4s Kc Ks Ac]
Seat 1: e13e3da1 showed [5d 5s] and lost with Pair of Kings and Pair of Fives
Seat 2: 148c23ae folded before Flop
Seat 3: 62a1d8c0 folded before Flop
Seat 4: Hero (button) showed [Td Ts] and won (5,200) with Pair of Kings and Pair of Tens
Seat 5: d7c2f8c8 (small blind) folded before Flop
Seat 6: 8638c512 (big blind) folded before Flop


Poker Hand #TM4180158409: Tournament #187165250, Mini Hypersonic $2.50 Hold'em No Limit - Level10(225/450) - 2025/02/03 16:30:04
Table '2' 6-max Seat #3 is the button
Seat 1: e13e3da1 (27,284 in chips)
Seat 2: 148c23ae (17,895 in chips)
Seat 3: 62a1d8c0 (8,643 in chips)
Seat 4: Hero (19,942 in chips)
Seat 5: d7c2f8c8 (10,392 in chips)
Seat 6: 8638c512 (26,826 in chips)
Hero: posts the ante 65
8638c512: posts the ante 65
148c23ae: posts the ante 65
62a1d8c0: posts the ante 65
e13e3da1: posts the ante 65
d7c2f8c8: posts the ante 65
Hero: posts small blind 225
d7c2f8c8: posts big blind 450
*** HOLE CARDS ***
Dealt to e13e3da1 
Dealt to 148c23ae 
Dealt to 62a1d8c0 
Dealt to Hero [7c 8s]
Dealt to d7c2f8c8 
Dealt to 8638c512 
8638c512: folds
e13e3da1: folds
148c23ae: folds
62a1d8c0: raises 450 to 900
Hero: folds
d7c2f8c8: calls 450
*** FLOP *** [Jd 7s Td]
d7c2f8c8: checks
62a1d8c0: bets 604
d7c2f8c8: calls 604
*** TURN *** [Jd 7s Td] [Ad]
d7c2f8c8: checks
62a1d8c0: bets 1,800
d7c2f8c8: calls 1,800
*** RIVER *** [Jd 7s Td Ad] [7h]
d7c2f8c8: checks
62a1d8c0: checks
d7c2f8c8: shows [6d Jc] (Pair of Jacks and Pair of Sevens)
62a1d8c0: shows [Ks 9s] (Pair of Sevens)
*** SHOWDOWN ***
d7c2f8c8 collected 7,223 from pot
*** SUMMARY ***
Total pot 7,223 | Rake 0 | Jackpot 0 | Bingo 0 | Fortune 0 | Tax 0
Board [Jd 7s Td Ad 7h]
Seat 1: e13e3da1 folded before Flop
Seat 2: 148c23ae folded before Flop
Seat 3: 62a1d8c0 (button) showed [Ks 9s] and lost with Pair of Sevens
Seat 4: Hero (small blind) folded before Flop
Seat 5: d7c2f8c8 (big blind) showed [6d Jc] and won (7,223) with Pair of Jacks and Pair of Sevens
Seat 6: 8638c512 folded before Flop


Poker Hand #TM4180158406: Tournament #187165250, Mini Hypersonic $2.50 Hold'em No Limit - Level10(225/450) - 2025/02/03 16:29:50
Table '2' 6-max Seat #2 is the button
Seat 1: e13e3da1 (27,349 in chips)
Seat 2: 148c23ae (17,960 in chips)
Seat 3: 62a1d8c0 (8,933 in chips)
Seat 4: Hero (19,392 in chips)
Seat 5: d7c2f8c8 (10,457 in chips)
Seat 6: 8638c512 (26,891 in chips)
Hero: posts the ante 65
8638c512: posts the ante 65
148c23ae: posts the ante 65
62a1d8c0: posts the ante 65
e13e3da1: posts the ante 65
d7c2f8c8: posts the ante 65
62a1d8c0: posts small blind 225
Hero: posts big blind 450
*** HOLE CARDS ***
Dealt to e13e3da1 
Dealt to 148c23ae 
Dealt to 62a1d8c0 
Dealt to Hero [5h 5c]
Dealt to d7c2f8c8 
Dealt to 8638c512 
d7c2f8c8: folds
8638c512: folds
e13e3da1: folds
148c23ae: folds
62a1d8c0: folds
Uncalled bet (225) returned to Hero
*** SHOWDOWN ***
Hero collected 840 from pot
*** SUMMARY ***
Total pot 840 | Rake 0 | Jackpot 0 | Bingo 0 | Fortune 0 | Tax 0
Seat 1: e13e3da1 folded before Flop
Seat 2: 148c23ae (button) folded before Flop
Seat 3: 62a1d8c0 (small blind) folded before Flop
Seat 4: Hero (big blind) collected (840)
Seat 5: d7c2f8c8 folded before Flop
Seat 6: 8638c512 folded before Flop


Poker Hand #TM4180158378: Tournament #187165250, Mini Hypersonic $2.50 Hold'em No Limit - Level10(225/450) - 2025/02/03 16:28:22
Table '2' 6-max Seat #1 is the button
Seat 1: e13e3da1 (33,063 in chips)
Seat 2: 148c23ae (18,250 in chips)
Seat 3: 62a1d8c0 (9,448 in chips)
Seat 4: Hero (12,743 in chips)
Seat 5: d7c2f8c8 (10,522 in chips)
Seat 6: 8638c512 (26,956 in chips)
Hero: posts the ante 65
8638c512: posts the ante 65
148c23ae: posts the ante 65
62a1d8c0: posts the ante 65
e13e3da1: posts the ante 65
d7c2f8c8: posts the ante 65
148c23ae: posts small blind 225
62a1d8c0: posts big blind 450
*** HOLE CARDS ***
Dealt to e13e3da1 
Dealt to 148c23ae 
Dealt to 62a1d8c0 
Dealt to Hero [Qd Ad]
Dealt to d7c2f8c8 
Dealt to 8638c512 
Hero: raises 450 to 900
d7c2f8c8: folds
8638c512: folds
e13e3da1: raises 1,883 to 2,783
148c23ae: folds
62a1d8c0: folds
Hero: calls 1,883
*** FLOP *** [Qs As Ac]
Hero: checks
e13e3da1: bets 2,866
Hero: calls 2,866
*** TURN *** [Qs As Ac] [3d]
Hero: checks
e13e3da1: checks
*** RIVER *** [Qs As Ac 3d] [4d]
Hero: bets 7,029 and is all-in
e13e3da1: folds
Uncalled bet (7,029) returned to Hero
*** SHOWDOWN ***
Hero collected 12,363 from pot
*** SUMMARY ***
Total pot 12,363 | Rake 0 | Jackpot 0 | Bingo 0 | Fortune 0 | Tax 0
Board [Qs As Ac 3d 4d]
Seat 1: e13e3da1 (button) folded on the River
Seat 2: 148c23ae (small blind) folded before Flop
Seat 3: 62a1d8c0 (big blind) folded before Flop
Seat 4: Hero won (12,363)
Seat 5: d7c2f8c8 folded before Flop
Seat 6: 8638c512 folded before Flop


Poker Hand #TM4180158371: Tournament #187165250, Mini Hypersonic $2.50 Hold'em No Limit - Level10(225/450) - 2025/02/03 16:28:01
Table '2' 6-max Seat #6 is the button
Seat 1: e13e3da1 (33,353 in chips)
Seat 2: 148c23ae (17,700 in chips)
Seat 3: 62a1d8c0 (9,513 in chips)
Seat 4: Hero (12,808 in chips)
Seat 5: d7c2f8c8 (10,587 in chips)
Seat 6: 8638c512 (27,021 in chips)
Hero: posts the ante 65
8638c512: posts the ante 65
148c23ae: posts the ante 65
62a1d8c0: posts the ante 65
d7c2f8c8: posts the ante 65
e13e3da1: posts the ante 65
e13e3da1: posts small blind 225
148c23ae: posts big blind 450
*** HOLE CARDS ***
Dealt to e13e3da1 
Dealt to 148c23ae 
Dealt to 62a1d8c0 
Dealt to Hero [6d Kd]
Dealt to d7c2f8c8 
Dealt to 8638c512 
62a1d8c0: folds
Hero: folds
d7c2f8c8: folds
8638c512: folds
e13e3da1: folds
Uncalled bet (225) returned to 148c23ae
*** SHOWDOWN ***
148c23ae collected 840 from pot
*** SUMMARY ***
Total pot 840 | Rake 0 | Jackpot 0 | Bingo 0 | Fortune 0 | Tax 0
Seat 1: e13e3da1 (small blind) folded before Flop
Seat 2: 148c23ae (big blind) collected (840)
Seat 3: 62a1d8c0 folded before Flop
Seat 4: Hero folded before Flop
Seat 5: d7c2f8c8 folded before Flop
Seat 6: 8638c512 (button) folded before Flop


Poker Hand #TM4180158357: Tournament #187165250, Mini Hypersonic $2.50 Hold'em No Limit - Level10(225/450) - 2025/02/03 16:27:09
Table '2' 6-max Seat #5 is the button
Seat 1: e13e3da1 (34,922 in chips)
Seat 2: 148c23ae (17,765 in chips)
Seat 3: 62a1d8c0 (9,578 in chips)
Seat 4: Hero (10,754 in chips)
Seat 5: d7c2f8c8 (10,652 in chips)
Seat 6: 8638c512 (27,311 in chips)
Hero: posts the ante 65
8638c512: posts the ante 65
148c23ae: posts the ante 65
62a1d8c0: posts the ante 65
d7c2f8c8: posts the ante 65
e13e3da1: posts the ante 65
8638c512: posts small blind 225
e13e3da1: posts big blind 450
*** HOLE CARDS ***
Dealt to e13e3da1 
Dealt to 148c23ae 
Dealt to 62a1d8c0 
Dealt to Hero [8h Kh]
Dealt to d7c2f8c8 
Dealt to 8638c512 
148c23ae: folds
62a1d8c0: folds
Hero: raises 450 to 900
d7c2f8c8: folds
8638c512: folds
e13e3da1: calls 450
*** FLOP *** [9d 5h Kc]
e13e3da1: checks
Hero: bets 604
e13e3da1: calls 604
*** TURN *** [9d 5h Kc] [6c]
e13e3da1: checks
Hero: bets 2,250
e13e3da1: folds
Uncalled bet (2,250) returned to Hero
*** SHOWDOWN ***
Hero collected 3,623 from pot
*** SUMMARY ***
Total pot 3,623 | Rake 0 | Jackpot 0 | Bingo 0 | Fortune 0 | Tax 0
Board [9d 5h Kc 6c]
Seat 1: e13e3da1 (big blind) folded on the Turn
Seat 2: 148c23ae folded before Flop
Seat 3: 62a1d8c0 folded before Flop
Seat 4: Hero won (3,623)
Seat 5: d7c2f8c8 (button) folded before Flop
Seat 6: 8638c512 (small blind) folded before Flop


Poker Hand #TM4180158349: Tournament #187165250, Mini Hypersonic $2.50 Hold'em No Limit - Level9(200/400) - 2025/02/03 16:26:39
Table '2' 6-max Seat #4 is the button
Seat 1: e13e3da1 (34,982 in chips)
Seat 2: 148c23ae (17,825 in chips)
Seat 3: 62a1d8c0 (8,278 in chips)
Seat 4: Hero (10,814 in chips)
Seat 5: d7c2f8c8 (10,912 in chips)
Seat 6: 8638c512 (28,171 in chips)
Hero: posts the ante 60
8638c512: posts the ante 60
148c23ae: posts the ante 60
62a1d8c0: posts the ante 60
e13e3da1: posts the ante 60
d7c2f8c8: posts the ante 60
d7c2f8c8: posts small blind 200
8638c512: posts big blind 400
*** HOLE CARDS ***
Dealt to e13e3da1 
Dealt to 148c23ae 
Dealt to 62a1d8c0 
Dealt to Hero [Ah 7d]
Dealt to d7c2f8c8 
Dealt to 8638c512 
e13e3da1: folds
148c23ae: folds
62a1d8c0: raises 400 to 800
Hero: folds
d7c2f8c8: folds
8638c512: calls 400
*** FLOP *** [3s Ts Qh]
8638c512: checks
62a1d8c0: bets 1,200
8638c512: folds
Uncalled bet (1,200) returned to 62a1d8c0
*** SHOWDOWN ***
62a1d8c0 collected 2,160 from pot
*** SUMMARY ***
Total pot 2,160 | Rake 0 | Jackpot 0 | Bingo 0 | Fortune 0 | Tax 0
Board [3s Ts Qh]
Seat 1: e13e3da1 folded before Flop
Seat 2: 148c23ae folded before Flop
Seat 3: 62a1d8c0 won (2,160)
Seat 4: Hero (button) folded before Flop
Seat 5: d7c2f8c8 (small blind) folded before Flop
Seat 6: 8638c512 (big blind) folded on the Flop


Poker Hand #TM4180158346: Tournament #187165250, Mini Hypersonic $2.50 Hold'em No Limit - Level9(200/400) - 2025/02/03 16:26:23
Table '2' 6-max Seat #3 is the button
Seat 1: e13e3da1 (35,042 in chips)
Seat 2: 148c23ae (17,885 in chips)
Seat 3: 62a1d8c0 (8,338 in chips)
Seat 4: Hero (11,074 in chips)
Seat 5: d7c2f8c8 (10,412 in chips)
Seat 6: 8638c512 (28,231 in chips)
Hero: posts the ante 60
8638c512: posts the ante 60
148c23ae: posts the ante 60
62a1d8c0: posts the ante 60
e13e3da1: posts the ante 60
d7c2f8c8: posts the ante 60
Hero: posts small blind 200
d7c2f8c8: posts big blind 400
*** HOLE CARDS ***
Dealt to e13e3da1 
Dealt to 148c23ae 
Dealt to 62a1d8c0 
Dealt to Hero [9h 3d]
Dealt to d7c2f8c8 
Dealt to 8638c512 
8638c512: folds
e13e3da1: folds
148c23ae: folds
62a1d8c0: folds
Hero: folds
Uncalled bet (200) returned to d7c2f8c8
*** SHOWDOWN ***
d7c2f8c8 collected 760 from pot
*** SUMMARY ***
Total pot 760 | Rake 0 | Jackpot 0 | Bingo 0 | Fortune 0 | Tax 0
Seat 1: e13e3da1 folded before Flop
Seat 2: 148c23ae folded before Flop
Seat 3: 62a1d8c0 (button) folded before Flop
Seat 4: Hero (small blind) folded before Flop
Seat 5: d7c2f8c8 (big blind) collected (760)
Seat 6: 8638c512 folded before Flop


Poker Hand #TM4180158330: Tournament #187165250, Mini Hypersonic $2.50 Hold'em No Limit - Level9(200/400) - 2025/02/03 16:25:29
Table '2' 6-max Seat #2 is the button
Seat 1: e13e3da1 (35,102 in chips)
Seat 2: 148c23ae (17,945 in chips)
Seat 3: 62a1d8c0 (8,598 in chips)
Seat 4: Hero (12,734 in chips)
Seat 5: d7c2f8c8 (10,472 in chips)
Seat 6: 8638c512 (26,131 in chips)
Hero: posts the ante 60
8638c512: posts the ante 60
148c23ae: posts the ante 60
62a1d8c0: posts the ante 60
e13e3da1: posts the ante 60
d7c2f8c8: posts the ante 60
62a1d8c0: posts small blind 200
Hero: posts big blind 400
*** HOLE CARDS ***
Dealt to e13e3da1 
Dealt to 148c23ae 
Dealt to 62a1d8c0 
Dealt to Hero [9d Js]
Dealt to d7c2f8c8 
Dealt to 8638c512 
d7c2f8c8: folds
8638c512: raises 480 to 880
e13e3da1: folds
148c23ae: folds
62a1d8c0: folds
Hero: calls 480
*** FLOP *** [Qh Ts Ah]
Hero: checks
8638c512: bets 720
Hero: calls 720
*** TURN *** [Qh Ts Ah] [7d]
Hero: checks
8638c512: checks
*** RIVER *** [Qh Ts Ah 7d] [9h]
Hero: checks
8638c512: checks
Hero: shows [9d Js] (Pair of Nines)
8638c512: shows [Td Kh] (Pair of Tens)
*** SHOWDOWN ***
8638c512 collected 3,760 from pot
*** SUMMARY ***
Total pot 3,760 | Rake 0 | Jackpot 0 | Bingo 0 | Fortune 0 | Tax 0
Board [Qh Ts Ah 7d 9h]
Seat 1: e13e3da1 folded before Flop
Seat 2: 148c23ae (button) folded before Flop
Seat 3: 62a1d8c0 (small blind) folded before Flop
Seat 4: Hero (big blind) showed [9d Js] and lost with Pair of Nines
Seat 5: d7c2f8c8 folded before Flop
Seat 6: 8638c512 showed [Td Kh] and won (3,760) with Pair of Tens


Poker Hand #TM4180158316: Tournament #187165250, Mini Hypersonic $2.50 Hold'em No Limit - Level9(200/400) - 2025/02/03 16:24:42
Table '2' 6-max Seat #6 is the button
Seat 2: 148c23ae (18,885 in chips)
Seat 3: 62a1d8c0 (9,058 in chips)
Seat 4: Hero (12,794 in chips)
Seat 5: d7c2f8c8 (8,952 in chips)
Seat 6: 8638c512 (26,191 in chips)
Hero: posts the ante 60
8638c512: posts the ante 60
148c23ae: posts the ante 60
62a1d8c0: posts the ante 60
d7c2f8c8: posts the ante 60
148c23ae: posts small blind 200
62a1d8c0: posts big blind 400
*** HOLE CARDS ***
Dealt to 148c23ae 
Dealt to 62a1d8c0 
Dealt to Hero [7c 8s]
Dealt to d7c2f8c8 
Dealt to 8638c512 
Hero: folds
d7c2f8c8: raises 480 to 880
8638c512: folds
148c23ae: calls 680
62a1d8c0: folds
*** FLOP *** [Jc 6h Ks]
148c23ae: checks
d7c2f8c8: bets 812
148c23ae: folds
Uncalled bet (812) returned to d7c2f8c8
*** SHOWDOWN ***
d7c2f8c8 collected 2,460 from pot
*** SUMMARY ***
Total pot 2,460 | Rake 0 | Jackpot 0 | Bingo 0 | Fortune 0 | Tax 0
Board [Jc 6h Ks]
Seat 2: 148c23ae (small blind) folded on the Flop
Seat 3: 62a1d8c0 (big blind) folded before Flop
Seat 4: Hero folded before Flop
Seat 5: d7c2f8c8 won (2,460)
Seat 6: 8638c512 (button) folded before Flop


Poker Hand #TM4180158294: Tournament #187165250, Mini Hypersonic $2.50 Hold'em No Limit - Level9(200/400) - 2025/02/03 16:23:42
Table '2' 6-max Seat #5 is the button
Seat 1: c0edb2ef (7,638 in chips)
Seat 2: 148c23ae (9,407 in chips)
Seat 3: 62a1d8c0 (9,118 in chips)
Seat 4: Hero (13,654 in chips)
Seat 5: d7c2f8c8 (9,012 in chips)
Seat 6: 8638c512 (27,051 in chips)
Hero: posts the ante 60
8638c512: posts the ante 60
148c23ae: posts the ante 60
62a1d8c0: posts the ante 60
d7c2f8c8: posts the ante 60
c0edb2ef: posts the ante 60
8638c512: posts small blind 200
c0edb2ef: posts big blind 400
*** HOLE CARDS ***
Dealt to c0edb2ef 
Dealt to 148c23ae 
Dealt to 62a1d8c0 
Dealt to Hero [9d Td]
Dealt to d7c2f8c8 
Dealt to 8638c512 
148c23ae: raises 400 to 800
62a1d8c0: folds
Hero: calls 800
d7c2f8c8: folds
8638c512: calls 600
c0edb2ef: raises 6,778 to 7,578 and is all-in
148c23ae: raises 1,769 to 9,347 and is all-in
Hero: folds
8638c512: folds
Uncalled bet (1,769) returned to 148c23ae
148c23ae: shows [Ah Tc]
c0edb2ef: shows [2s Ad]
*** FLOP *** [6d 5c 9h]
*** TURN *** [6d 5c 9h] [3d]
*** RIVER *** [6d 5c 9h 3d] [Qc]
*** SHOWDOWN ***
148c23ae collected 17,116 from pot
*** SUMMARY ***
Total pot 17,116 | Rake 0 | Jackpot 0 | Bingo 0 | Fortune 0 | Tax 0
Board [6d 5c 9h 3d Qc]
Seat 1: c0edb2ef (big blind) showed [2s Ad] and lost with Ace-High
Seat 2: 148c23ae showed [Ah Tc] and won (17,116) with Ace-High
Seat 3: 62a1d8c0 folded before Flop
Seat 4: Hero folded before Flop
Seat 5: d7c2f8c8 (button) folded before Flop
Seat 6: 8638c512 (small blind) folded before Flop


Poker Hand #TM4180158278: Tournament #187165250, Mini Hypersonic $2.50 Hold'em No Limit - Level8(175/350) - 2025/02/03 16:22:49
Table '2' 6-max Seat #4 is the button
Seat 1: c0edb2ef (8,388 in chips)
Seat 2: 148c23ae (9,457 in chips)
Seat 3: 62a1d8c0 (9,168 in chips)
Seat 4: Hero (17,535 in chips)
Seat 5: d7c2f8c8 (3,881 in chips)
Seat 6: 8638c512 (27,451 in chips)
Hero: posts the ante 50
8638c512: posts the ante 50
148c23ae: posts the ante 50
62a1d8c0: posts the ante 50
c0edb2ef: posts the ante 50
d7c2f8c8: posts the ante 50
d7c2f8c8: posts small blind 175
8638c512: posts big blind 350
*** HOLE CARDS ***
Dealt to c0edb2ef 
Dealt to 148c23ae 
Dealt to 62a1d8c0 
Dealt to Hero [Ad 3d]
Dealt to d7c2f8c8 
Dealt to 8638c512 
c0edb2ef: raises 350 to 700
148c23ae: folds
62a1d8c0: folds
Hero: raises 1,400 to 2,100
d7c2f8c8: raises 1,731 to 3,831 and is all-in
8638c512: folds
c0edb2ef: folds
Hero: calls 1,731
d7c2f8c8: shows [Qc Qs]
Hero: shows [Ad 3d]
*** FLOP *** [7s 2s 5h]
*** TURN *** [7s 2s 5h] [Kd]
*** RIVER *** [7s 2s 5h Kd] [Tc]
*** SHOWDOWN ***
d7c2f8c8 collected 9,012 from pot
*** SUMMARY ***
Total pot 9,012 | Rake 0 | Jackpot 0 | Bingo 0 | Fortune 0 | Tax 0
Board [7s 2s 5h Kd Tc]
Seat 1: c0edb2ef folded before Flop
Seat 2: 148c23ae folded before Flop
Seat 3: 62a1d8c0 folded before Flop
Seat 4: Hero (button) showed [Ad 3d] and lost with Ace-High
Seat 5: d7c2f8c8 (small blind) showed [Qc Qs] and won (9,012) with Pair of Queens
Seat 6: 8638c512 (big blind) folded before Flop


Poker Hand #TM4180158268: Tournament #187165250, Mini Hypersonic $2.50 Hold'em No Limit - Level8(175/350) - 2025/02/03 16:22:11
Table '2' 6-max Seat #3 is the button
Seat 1: c0edb2ef (10,188 in chips)
Seat 2: 148c23ae (9,507 in chips)
Seat 3: 62a1d8c0 (6,643 in chips)
Seat 4: Hero (17,760 in chips)
Seat 5: d7c2f8c8 (4,281 in chips)
Seat 6: 8638c512 (27,501 in chips)
Hero: posts the ante 50
8638c512: posts the ante 50
148c23ae: posts the ante 50
62a1d8c0: posts the ante 50
c0edb2ef: posts the ante 50
d7c2f8c8: posts the ante 50
Hero: posts small blind 175
d7c2f8c8: posts big blind 350
*** HOLE CARDS ***
Dealt to c0edb2ef 
Dealt to 148c23ae 
Dealt to 62a1d8c0 
Dealt to Hero [Jh 5s]
Dealt to d7c2f8c8 
Dealt to 8638c512 
8638c512: folds
c0edb2ef: raises 350 to 700
148c23ae: folds
62a1d8c0: raises 1,050 to 1,750
Hero: folds
d7c2f8c8: folds
c0edb2ef: calls 1,050
*** FLOP *** [9s 7c 3h]
c0edb2ef: checks
62a1d8c0: bets 1,400
c0edb2ef: folds
Uncalled bet (1,400) returned to 62a1d8c0
*** SHOWDOWN ***
62a1d8c0 collected 4,325 from pot
*** SUMMARY ***
Total pot 4,325 | Rake 0 | Jackpot 0 | Bingo 0 | Fortune 0 | Tax 0
Board [9s 7c 3h]
Seat 1: c0edb2ef folded on the Flop
Seat 2: 148c23ae folded before Flop
Seat 3: 62a1d8c0 (button) won (4,325)
Seat 4: Hero (small blind) folded before Flop
Seat 5: d7c2f8c8 (big blind) folded before Flop
Seat 6: 8638c512 folded before Flop


Poker Hand #TM4180158259: Tournament #187165250, Mini Hypersonic $2.50 Hold'em No Limit - Level8(175/350) - 2025/02/03 16:21:44
Table '2' 6-max Seat #2 is the button
Seat 1: c0edb2ef (10,238 in chips)
Seat 2: 148c23ae (9,557 in chips)
Seat 3: 62a1d8c0 (6,868 in chips)
Seat 4: Hero (18,160 in chips)
Seat 5: d7c2f8c8 (3,506 in chips)
Seat 6: 8638c512 (27,551 in chips)
Hero: posts the ante 50
8638c512: posts the ante 50
148c23ae: posts the ante 50
62a1d8c0: posts the ante 50
c0edb2ef: posts the ante 50
d7c2f8c8: posts the ante 50
62a1d8c0: posts small blind 175
Hero: posts big blind 350
*** HOLE CARDS ***
Dealt to c0edb2ef 
Dealt to 148c23ae 
Dealt to 62a1d8c0 
Dealt to Hero [2d 4h]
Dealt to d7c2f8c8 
Dealt to 8638c512 
d7c2f8c8: raises 3,106 to 3,456 and is all-in
8638c512: folds
c0edb2ef: folds
148c23ae: folds
62a1d8c0: folds
Hero: folds
Uncalled bet (3,106) returned to d7c2f8c8
*** SHOWDOWN ***
d7c2f8c8 collected 1,175 from pot
*** SUMMARY ***
Total pot 1,175 | Rake 0 | Jackpot 0 | Bingo 0 | Fortune 0 | Tax 0
Seat 1: c0edb2ef folded before Flop
Seat 2: 148c23ae (button) folded before Flop
Seat 3: 62a1d8c0 (small blind) folded before Flop
Seat 4: Hero (big blind) folded before Flop
Seat 5: d7c2f8c8 collected (1,175)
Seat 6: 8638c512 folded before Flop


Poker Hand #TM4180158241: Tournament #187165250, Mini Hypersonic $2.50 Hold'em No Limit - Level8(175/350) - 2025/02/03 16:20:45
Table '2' 6-max Seat #1 is the button
Seat 1: c0edb2ef (10,288 in chips)
Seat 2: 148c23ae (7,464 in chips)
Seat 3: 62a1d8c0 (7,268 in chips)
Seat 4: Hero (18,210 in chips)
Seat 5: d7c2f8c8 (3,556 in chips)
Seat 6: 8638c512 (29,094 in chips)
Hero: posts the ante 50
8638c512: posts the ante 50
148c23ae: posts the ante 50
62a1d8c0: posts the ante 50
c0edb2ef: posts the ante 50
d7c2f8c8: posts the ante 50
148c23ae: posts small blind 175
62a1d8c0: posts big blind 350
*** HOLE CARDS ***
Dealt to c0edb2ef 
Dealt to 148c23ae 
Dealt to 62a1d8c0 
Dealt to Hero [Qh 8c]
Dealt to d7c2f8c8 
Dealt to 8638c512 
Hero: folds
d7c2f8c8: folds
8638c512: raises 420 to 770
c0edb2ef: folds
148c23ae: calls 595
62a1d8c0: folds
*** FLOP *** [4d 4s 7s]
148c23ae: checks
8638c512: checks
*** TURN *** [4d 4s 7s] [5h]
148c23ae: bets 723
8638c512: calls 723
*** RIVER *** [4d 4s 7s 5h] [Ks]
148c23ae: bets 5,921 and is all-in
8638c512: folds
Uncalled bet (5,921) returned to 148c23ae
*** SHOWDOWN ***
148c23ae collected 3,636 from pot
*** SUMMARY ***
Total pot 3,636 | Rake 0 | Jackpot 0 | Bingo 0 | Fortune 0 | Tax 0
Board [4d 4s 7s 5h Ks]
Seat 1: c0edb2ef (button) folded before Flop
Seat 2: 148c23ae (small blind) won (3,636)
Seat 3: 62a1d8c0 (big blind) folded before Flop
Seat 4: Hero folded before Flop
Seat 5: d7c2f8c8 folded before Flop
Seat 6: 8638c512 folded on the River


Poker Hand #TM4180158210: Tournament #187165250, Mini Hypersonic $2.50 Hold'em No Limit - Level7(150/300) - 2025/02/03 16:19:05
Table '2' 6-max Seat #6 is the button
Seat 1: c0edb2ef (10,483 in chips)
Seat 2: 148c23ae (9,219 in chips)
Seat 3: 62a1d8c0 (7,313 in chips)
Seat 4: Hero (19,965 in chips)
Seat 5: d7c2f8c8 (3,601 in chips)
Seat 6: 8638c512 (25,299 in chips)
Hero: posts the ante 45
8638c512: posts the ante 45
148c23ae: posts the ante 45
62a1d8c0: posts the ante 45
d7c2f8c8: posts the ante 45
c0edb2ef: posts the ante 45
c0edb2ef: posts small blind 150
148c23ae: posts big blind 300
*** HOLE CARDS ***
Dealt to c0edb2ef 
Dealt to 148c23ae 
Dealt to 62a1d8c0 
Dealt to Hero [Js Kh]
Dealt to d7c2f8c8 
Dealt to 8638c512 
62a1d8c0: folds
Hero: raises 300 to 600
d7c2f8c8: folds
8638c512: calls 600
c0edb2ef: folds
148c23ae: calls 300
*** FLOP *** [7h 2h Qs]
148c23ae: checks
Hero: checks
8638c512: checks
*** TURN *** [7h 2h Qs] [Tc]
148c23ae: bets 1,110
Hero: calls 1,110
8638c512: calls 1,110
*** RIVER *** [7h 2h Qs Tc] [Ts]
148c23ae: checks
Hero: checks
8638c512: bets 5,463
148c23ae: folds
Hero: folds
Uncalled bet (5,463) returned to 8638c512
*** SHOWDOWN ***
8638c512 collected 5,550 from pot
*** SUMMARY ***
Total pot 5,550 | Rake 0 | Jackpot 0 | Bingo 0 | Fortune 0 | Tax 0
Board [7h 2h Qs Tc Ts]
Seat 1: c0edb2ef (small blind) folded before Flop
Seat 2: 148c23ae (big blind) folded on the River
Seat 3: 62a1d8c0 folded before Flop
Seat 4: Hero folded on the River
Seat 5: d7c2f8c8 folded before Flop
Seat 6: 8638c512 (button) won (5,550)


Poker Hand #TM4180158203: Tournament #187165250, Mini Hypersonic $2.50 Hold'em No Limit - Level7(150/300) - 2025/02/03 16:18:38
Table '2' 6-max Seat #5 is the button
Seat 1: c0edb2ef (9,358 in chips)
Seat 2: 148c23ae (9,264 in chips)
Seat 3: 62a1d8c0 (7,358 in chips)
Seat 4: Hero (20,010 in chips)
Seat 5: d7c2f8c8 (3,646 in chips)
Seat 6: 8638c512 (26,244 in chips)
Hero: posts the ante 45
8638c512: posts the ante 45
148c23ae: posts the ante 45
62a1d8c0: posts the ante 45
d7c2f8c8: posts the ante 45
c0edb2ef: posts the ante 45
8638c512: posts small blind 150
c0edb2ef: posts big blind 300
*** HOLE CARDS ***
Dealt to c0edb2ef 
Dealt to 148c23ae 
Dealt to 62a1d8c0 
Dealt to Hero [7d 4d]
Dealt to d7c2f8c8 
Dealt to 8638c512 
148c23ae: folds
62a1d8c0: folds
Hero: folds
d7c2f8c8: folds
8638c512: raises 600 to 900
c0edb2ef: raises 8,413 to 9,313 and is all-in
8638c512: folds
Uncalled bet (8,413) returned to c0edb2ef
*** SHOWDOWN ***
c0edb2ef collected 2,070 from pot
*** SUMMARY ***
Total pot 2,070 | Rake 0 | Jackpot 0 | Bingo 0 | Fortune 0 | Tax 0
Seat 1: c0edb2ef (big blind) showed [3h 3c] and collected (2,070)
Seat 2: 148c23ae folded before Flop
Seat 3: 62a1d8c0 folded before Flop
Seat 4: Hero folded before Flop
Seat 5: d7c2f8c8 (button) folded before Flop
Seat 6: 8638c512 (small blind) folded before Flop


Poker Hand #TM4180158192: Tournament #187165250, Mini Hypersonic $2.50 Hold'em No Limit - Level7(150/300) - 2025/02/03 16:18:00
Table '2' 6-max Seat #4 is the button
Seat 1: c0edb2ef (9,403 in chips)
Seat 2: 148c23ae (9,909 in chips)
Seat 3: 62a1d8c0 (7,403 in chips)
Seat 4: Hero (20,055 in chips)
Seat 5: d7c2f8c8 (4,975 in chips)
Seat 6: 8638c512 (24,135 in chips)
Hero: posts the ante 45
8638c512: posts the ante 45
148c23ae: posts the ante 45
62a1d8c0: posts the ante 45
c0edb2ef: posts the ante 45
d7c2f8c8: posts the ante 45
d7c2f8c8: posts small blind 150
8638c512: posts big blind 300
*** HOLE CARDS ***
Dealt to c0edb2ef 
Dealt to 148c23ae 
Dealt to 62a1d8c0 
Dealt to Hero [Qh 3c]
Dealt to d7c2f8c8 
Dealt to 8638c512 
c0edb2ef: folds
148c23ae: raises 300 to 600
62a1d8c0: folds
Hero: folds
d7c2f8c8: calls 450
8638c512: calls 300
*** FLOP *** [4s 5d 6s]
d7c2f8c8: bets 684
8638c512: raises 1,670 to 2,354
148c23ae: folds
d7c2f8c8: folds
Uncalled bet (1,670) returned to 8638c512
*** SHOWDOWN ***
8638c512 collected 3,438 from pot
*** SUMMARY ***
Total pot 3,438 | Rake 0 | Jackpot 0 | Bingo 0 | Fortune 0 | Tax 0
Board [4s 5d 6s]
Seat 1: c0edb2ef folded before Flop
Seat 2: 148c23ae folded on the Flop
Seat 3: 62a1d8c0 folded before Flop
Seat 4: Hero (button) folded before Flop
Seat 5: d7c2f8c8 (small blind) folded on the Flop
Seat 6: 8638c512 (big blind) won (3,438)


Poker Hand #TM4180158184: Tournament #187165250, Mini Hypersonic $2.50 Hold'em No Limit - Level7(150/300) - 2025/02/03 16:17:26
Table '2' 6-max Seat #3 is the button
Seat 1: c0edb2ef (7,593 in chips)
Seat 2: 148c23ae (9,954 in chips)
Seat 3: 62a1d8c0 (7,448 in chips)
Seat 4: Hero (20,250 in chips)
Seat 5: d7c2f8c8 (6,455 in chips)
Seat 6: 8638c512 (24,180 in chips)
Hero: posts the ante 45
8638c512: posts the ante 45
148c23ae: posts the ante 45
62a1d8c0: posts the ante 45
c0edb2ef: posts the ante 45
d7c2f8c8: posts the ante 45
Hero: posts small blind 150
d7c2f8c8: posts big blind 300
*** HOLE CARDS ***
Dealt to c0edb2ef 
Dealt to 148c23ae 
Dealt to 62a1d8c0 
Dealt to Hero [4d 2c]
Dealt to d7c2f8c8 
Dealt to 8638c512 
8638c512: folds
c0edb2ef: raises 300 to 600
148c23ae: folds
62a1d8c0: folds
Hero: folds
d7c2f8c8: calls 300
*** FLOP *** [Qd 8c 3s]
d7c2f8c8: checks
c0edb2ef: checks
*** TURN *** [Qd 8c 3s] [Jc]
d7c2f8c8: bets 835
c0edb2ef: calls 835
*** RIVER *** [Qd 8c 3s Jc] [Th]
d7c2f8c8: checks
c0edb2ef: checks
d7c2f8c8: shows [Js Ah] (Pair of Jacks)
c0edb2ef: shows [Ts Tc] (Three Tens)
*** SHOWDOWN ***
c0edb2ef collected 3,290 from pot
*** SUMMARY ***
Total pot 3,290 | Rake 0 | Jackpot 0 | Bingo 0 | Fortune 0 | Tax 0
Board [Qd 8c 3s Jc Th]
Seat 1: c0edb2ef showed [Ts Tc] and won (3,290) with Three Tens
Seat 2: 148c23ae folded before Flop
Seat 3: 62a1d8c0 (button) folded before Flop
Seat 4: Hero (small blind) folded before Flop
Seat 5: d7c2f8c8 (big blind) showed [Js Ah] and lost with Pair of Jacks
Seat 6: 8638c512 folded before Flop


Poker Hand #TM4180158159: Tournament #187165250, Mini Hypersonic $2.50 Hold'em No Limit - Level7(150/300) - 2025/02/03 16:16:02
Table '2' 6-max Seat #2 is the button
Seat 1: c0edb2ef (7,638 in chips)
Seat 2: 148c23ae (9,999 in chips)
Seat 3: 62a1d8c0 (7,643 in chips)
Seat 4: Hero (21,855 in chips)
Seat 5: d7c2f8c8 (6,500 in chips)
Seat 6: 8638c512 (22,245 in chips)
Hero: posts the ante 45
8638c512: posts the ante 45
148c23ae: posts the ante 45
62a1d8c0: posts the ante 45
c0edb2ef: posts the ante 45
d7c2f8c8: posts the ante 45
62a1d8c0: posts small blind 150
Hero: posts big blind 300
*** HOLE CARDS ***
Dealt to c0edb2ef 
Dealt to 148c23ae 
Dealt to 62a1d8c0 
Dealt to Hero [4d 8d]
Dealt to d7c2f8c8 
Dealt to 8638c512 
d7c2f8c8: folds
8638c512: raises 360 to 660
c0edb2ef: folds
148c23ae: folds
62a1d8c0: folds
Hero: calls 360
*** FLOP *** [Jd Td Ts]
Hero: checks
8638c512: checks
*** TURN *** [Jd Td Ts] [2c]
Hero: checks
8638c512: checks
*** RIVER *** [Jd Td Ts 2c] [Th]
Hero: bets 900
8638c512: calls 900
Hero: shows [4d 8d] (Three Tens)
8638c512: shows [3h 3s] (Tens Full over Treys)
*** SHOWDOWN ***
8638c512 collected 3,540 from pot
*** SUMMARY ***
Total pot 3,540 | Rake 0 | Jackpot 0 | Bingo 0 | Fortune 0 | Tax 0
Board [Jd Td Ts 2c Th]
Seat 1: c0edb2ef folded before Flop
Seat 2: 148c23ae (button) folded before Flop
Seat 3: 62a1d8c0 (small blind) folded before Flop
Seat 4: Hero (big blind) showed [4d 8d] and lost with Three Tens
Seat 5: d7c2f8c8 folded before Flop
Seat 6: 8638c512 showed [3h 3s] and won (3,540) with Tens Full over Treys


Poker Hand #TM4180158151: Tournament #187165250, Mini Hypersonic $2.50 Hold'em No Limit - Level7(150/300) - 2025/02/03 16:15:38
Table '2' 6-max Seat #1 is the button
Seat 1: c0edb2ef (7,683 in chips)
Seat 2: 148c23ae (10,194 in chips)
Seat 3: 62a1d8c0 (7,988 in chips)
Seat 4: Hero (21,900 in chips)
Seat 5: d7c2f8c8 (6,545 in chips)
Seat 6: 8638c512 (21,570 in chips)
Hero: posts the ante 45
8638c512: posts the ante 45
148c23ae: posts the ante 45
62a1d8c0: posts the ante 45
c0edb2ef: posts the ante 45
d7c2f8c8: posts the ante 45
148c23ae: posts small blind 150
62a1d8c0: posts big blind 300
*** HOLE CARDS ***
Dealt to c0edb2ef 
Dealt to 148c23ae 
Dealt to 62a1d8c0 
Dealt to Hero [Kh 2d]
Dealt to d7c2f8c8 
Dealt to 8638c512 
Hero: folds
d7c2f8c8: folds
8638c512: raises 360 to 660
c0edb2ef: folds
148c23ae: folds
62a1d8c0: folds
Uncalled bet (360) returned to 8638c512
*** SHOWDOWN ***
8638c512 collected 1,020 from pot
*** SUMMARY ***
Total pot 1,020 | Rake 0 | Jackpot 0 | Bingo 0 | Fortune 0 | Tax 0
Seat 1: c0edb2ef (button) folded before Flop
Seat 2: 148c23ae (small blind) folded before Flop
Seat 3: 62a1d8c0 (big blind) folded before Flop
Seat 4: Hero folded before Flop
Seat 5: d7c2f8c8 folded before Flop
Seat 6: 8638c512 collected (1,020)


Poker Hand #TM4180158142: Tournament #187165250, Mini Hypersonic $2.50 Hold'em No Limit - Level6(125/250) - 2025/02/03 16:15:07
Table '2' 6-max Seat #6 is the button
Seat 1: c0edb2ef (8,468 in chips)
Seat 2: 148c23ae (9,269 in chips)
Seat 3: 62a1d8c0 (8,023 in chips)
Seat 4: Hero (21,935 in chips)
Seat 5: d7c2f8c8 (6,580 in chips)
Seat 6: 8638c512 (21,605 in chips)
Hero: posts the ante 35
8638c512: posts the ante 35
148c23ae: posts the ante 35
62a1d8c0: posts the ante 35
d7c2f8c8: posts the ante 35
c0edb2ef: posts the ante 35
c0edb2ef: posts small blind 125
148c23ae: posts big blind 250
*** HOLE CARDS ***
Dealt to c0edb2ef 
Dealt to 148c23ae 
Dealt to 62a1d8c0 
Dealt to Hero [7d 3c]
Dealt to d7c2f8c8 
Dealt to 8638c512 
62a1d8c0: folds
Hero: folds
d7c2f8c8: folds
8638c512: folds
c0edb2ef: calls 125
148c23ae: checks
*** FLOP *** [7h Qc Kh]
c0edb2ef: checks
148c23ae: bets 250
c0edb2ef: calls 250
*** TURN *** [7h Qc Kh] [Jh]
c0edb2ef: checks
148c23ae: checks
*** RIVER *** [7h Qc Kh Jh] [9h]
c0edb2ef: checks
148c23ae: bets 250
c0edb2ef: calls 250
148c23ae: shows [Qs 6h] (King High Flush)
c0edb2ef: shows [Kd 4d] (Pair of Kings)
*** SHOWDOWN ***
148c23ae collected 1,710 from pot
*** SUMMARY ***
Total pot 1,710 | Rake 0 | Jackpot 0 | Bingo 0 | Fortune 0 | Tax 0
Board [7h Qc Kh Jh 9h]
Seat 1: c0edb2ef (small blind) showed [Kd 4d] and lost with Pair of Kings
Seat 2: 148c23ae (big blind) showed [Qs 6h] and won (1,710) with King High Flush
Seat 3: 62a1d8c0 folded before Flop
Seat 4: Hero folded before Flop
Seat 5: d7c2f8c8 folded before Flop
Seat 6: 8638c512 (button) folded before Flop


Poker Hand #TM4180158136: Tournament #187165250, Mini Hypersonic $2.50 Hold'em No Limit - Level6(125/250) - 2025/02/03 16:14:37
Table '2' 6-max Seat #5 is the button
Seat 1: c0edb2ef (7,543 in chips)
Seat 2: 148c23ae (9,304 in chips)
Seat 3: 62a1d8c0 (8,058 in chips)
Seat 4: Hero (21,970 in chips)
Seat 5: d7c2f8c8 (6,615 in chips)
Seat 6: 8638c512 (22,390 in chips)
Hero: posts the ante 35
8638c512: posts the ante 35
148c23ae: posts the ante 35
62a1d8c0: posts the ante 35
d7c2f8c8: posts the ante 35
c0edb2ef: posts the ante 35
8638c512: posts small blind 125
c0edb2ef: posts big blind 250
*** HOLE CARDS ***
Dealt to c0edb2ef 
Dealt to 148c23ae 
Dealt to 62a1d8c0 
Dealt to Hero [2c 5h]
Dealt to d7c2f8c8 
Dealt to 8638c512 
148c23ae: folds
62a1d8c0: folds
Hero: folds
d7c2f8c8: folds
8638c512: raises 500 to 750
c0edb2ef: raises 6,758 to 7,508 and is all-in
8638c512: folds
Uncalled bet (6,758) returned to c0edb2ef
*** SHOWDOWN ***
c0edb2ef collected 1,710 from pot
*** SUMMARY ***
Total pot 1,710 | Rake 0 | Jackpot 0 | Bingo 0 | Fortune 0 | Tax 0
Seat 1: c0edb2ef (big blind) collected (1,710)
Seat 2: 148c23ae folded before Flop
Seat 3: 62a1d8c0 folded before Flop
Seat 4: Hero folded before Flop
Seat 5: d7c2f8c8 (button) folded before Flop
Seat 6: 8638c512 (small blind) folded before Flop


Poker Hand #TM4180158130: Tournament #187165250, Mini Hypersonic $2.50 Hold'em No Limit - Level6(125/250) - 2025/02/03 16:14:18
Table '2' 6-max Seat #4 is the button
Seat 1: c0edb2ef (7,578 in chips)
Seat 2: 148c23ae (9,339 in chips)
Seat 3: 62a1d8c0 (8,093 in chips)
Seat 4: Hero (22,005 in chips)
Seat 5: d7c2f8c8 (6,775 in chips)
Seat 6: 8638c512 (22,090 in chips)
Hero: posts the ante 35
8638c512: posts the ante 35
148c23ae: posts the ante 35
62a1d8c0: posts the ante 35
c0edb2ef: posts the ante 35
d7c2f8c8: posts the ante 35
d7c2f8c8: posts small blind 125
8638c512: posts big blind 250
*** HOLE CARDS ***
Dealt to c0edb2ef 
Dealt to 148c23ae 
Dealt to 62a1d8c0 
Dealt to Hero [7h 4s]
Dealt to d7c2f8c8 
Dealt to 8638c512 
c0edb2ef: folds
148c23ae: folds
62a1d8c0: folds
Hero: folds
d7c2f8c8: folds
Uncalled bet (125) returned to 8638c512
*** SHOWDOWN ***
8638c512 collected 460 from pot
*** SUMMARY ***
Total pot 460 | Rake 0 | Jackpot 0 | Bingo 0 | Fortune 0 | Tax 0
Seat 1: c0edb2ef folded before Flop
Seat 2: 148c23ae folded before Flop
Seat 3: 62a1d8c0 folded before Flop
Seat 4: Hero (button) folded before Flop
Seat 5: d7c2f8c8 (small blind) folded before Flop
Seat 6: 8638c512 (big blind) collected (460)


Poker Hand #TM4180158116: Tournament #187165250, Mini Hypersonic $2.50 Hold'em No Limit - Level6(125/250) - 2025/02/03 16:13:38
Table '2' 6-max Seat #3 is the button
Seat 1: c0edb2ef (6,004 in chips)
Seat 2: 148c23ae (10,398 in chips)
Seat 3: 62a1d8c0 (8,128 in chips)
Seat 4: Hero (22,165 in chips)
Seat 5: d7c2f8c8 (7,060 in chips)
Seat 6: 8638c512 (22,125 in chips)
Hero: posts the ante 35
8638c512: posts the ante 35
148c23ae: posts the ante 35
62a1d8c0: posts the ante 35
c0edb2ef: posts the ante 35
d7c2f8c8: posts the ante 35
Hero: posts small blind 125
d7c2f8c8: posts big blind 250
*** HOLE CARDS ***
Dealt to c0edb2ef 
Dealt to 148c23ae 
Dealt to 62a1d8c0 
Dealt to Hero [8s Ad]
Dealt to d7c2f8c8 
Dealt to 8638c512 
8638c512: folds
c0edb2ef: raises 250 to 500
148c23ae: calls 500
62a1d8c0: folds
Hero: folds
d7c2f8c8: folds
*** FLOP *** [3c Jd 4s]
c0edb2ef: checks
148c23ae: checks
*** TURN *** [3c Jd 4s] [9c]
c0edb2ef: bets 524
148c23ae: calls 524
*** RIVER *** [3c Jd 4s 9c] [4h]
c0edb2ef: bets 4,945 and is all-in
148c23ae: folds
Uncalled bet (4,945) returned to c0edb2ef
*** SHOWDOWN ***
c0edb2ef collected 2,633 from pot
*** SUMMARY ***
Total pot 2,633 | Rake 0 | Jackpot 0 | Bingo 0 | Fortune 0 | Tax 0
Board [3c Jd 4s 9c 4h]
Seat 1: c0edb2ef showed [Kd Th] and won (2,633)
Seat 2: 148c23ae folded on the River
Seat 3: 62a1d8c0 (button) folded before Flop
Seat 4: Hero (small blind) folded before Flop
Seat 5: d7c2f8c8 (big blind) folded before Flop
Seat 6: 8638c512 folded before Flop


Poker Hand #TM4180158113: Tournament #187165250, Mini Hypersonic $2.50 Hold'em No Limit - Level6(125/250) - 2025/02/03 16:13:23
Table '2' 6-max Seat #2 is the button
Seat 1: c0edb2ef (6,039 in chips)
Seat 2: 148c23ae (10,433 in chips)
Seat 3: 62a1d8c0 (8,288 in chips)
Seat 4: Hero (21,865 in chips)
Seat 5: d7c2f8c8 (7,095 in chips)
Seat 6: 8638c512 (22,160 in chips)
Hero: posts the ante 35
8638c512: posts the ante 35
148c23ae: posts the ante 35
62a1d8c0: posts the ante 35
c0edb2ef: posts the ante 35
d7c2f8c8: posts the ante 35
62a1d8c0: posts small blind 125
Hero: posts big blind 250
*** HOLE CARDS ***
Dealt to c0edb2ef 
Dealt to 148c23ae 
Dealt to 62a1d8c0 
Dealt to Hero [2h 2c]
Dealt to d7c2f8c8 
Dealt to 8638c512 
d7c2f8c8: folds
8638c512: folds
c0edb2ef: folds
148c23ae: folds
62a1d8c0: folds
Uncalled bet (125) returned to Hero
*** SHOWDOWN ***
Hero collected 460 from pot
*** SUMMARY ***
Total pot 460 | Rake 0 | Jackpot 0 | Bingo 0 | Fortune 0 | Tax 0
Seat 1: c0edb2ef folded before Flop
Seat 2: 148c23ae (button) folded before Flop
Seat 3: 62a1d8c0 (small blind) folded before Flop
Seat 4: Hero (big blind) collected (460)
Seat 5: d7c2f8c8 folded before Flop
Seat 6: 8638c512 folded before Flop


Poker Hand #TM4180158100: Tournament #187165250, Mini Hypersonic $2.50 Hold'em No Limit - Level6(125/250) - 2025/02/03 16:12:41
Table '2' 6-max Seat #1 is the button
Seat 1: c0edb2ef (6,074 in chips)
Seat 2: 148c23ae (9,758 in chips)
Seat 3: 62a1d8c0 (8,823 in chips)
Seat 4: Hero (21,900 in chips)
Seat 5: d7c2f8c8 (7,130 in chips)
Seat 6: 8638c512 (22,195 in chips)
Hero: posts the ante 35
8638c512: posts the ante 35
148c23ae: posts the ante 35
62a1d8c0: posts the ante 35
c0edb2ef: posts the ante 35
d7c2f8c8: posts the ante 35
148c23ae: posts small blind 125
62a1d8c0: posts big blind 250
*** HOLE CARDS ***
Dealt to c0edb2ef 
Dealt to 148c23ae 
Dealt to 62a1d8c0 
Dealt to Hero [3h Th]
Dealt to d7c2f8c8 
Dealt to 8638c512 
Hero: folds
d7c2f8c8: folds
8638c512: folds
c0edb2ef: folds
148c23ae: calls 125
62a1d8c0: checks
*** FLOP *** [7c 9s Jd]
148c23ae: checks
62a1d8c0: checks
*** TURN *** [7c 9s Jd] [5d]
148c23ae: bets 250
62a1d8c0: calls 250
*** RIVER *** [7c 9s Jd 5d] [Ad]
148c23ae: checks
62a1d8c0: checks
148c23ae: shows [7h 4h] (Pair of Sevens)
62a1d8c0: shows [Kd 5s] (Pair of Fives)
*** SHOWDOWN ***
148c23ae collected 1,210 from pot
*** SUMMARY ***
Total pot 1,210 | Rake 0 | Jackpot 0 | Bingo 0 | Fortune 0 | Tax 0
Board [7c 9s Jd 5d Ad]
Seat 1: c0edb2ef (button) folded before Flop
Seat 2: 148c23ae (small blind) showed [7h 4h] and won (1,210) with Pair of Sevens
Seat 3: 62a1d8c0 (big blind) showed [Kd 5s] and lost with Pair of Fives
Seat 4: Hero folded before Flop
Seat 5: d7c2f8c8 folded before Flop
Seat 6: 8638c512 folded before Flop


Poker Hand #TM4180158092: Tournament #187165250, Mini Hypersonic $2.50 Hold'em No Limit - Level6(125/250) - 2025/02/03 16:12:12
Table '2' 6-max Seat #6 is the button
Seat 1: c0edb2ef (6,234 in chips)
Seat 2: 148c23ae (9,458 in chips)
Seat 3: 62a1d8c0 (8,858 in chips)
Seat 4: Hero (21,935 in chips)
Seat 5: d7c2f8c8 (7,165 in chips)
Seat 6: 8638c512 (22,230 in chips)
Hero: posts the ante 35
8638c512: posts the ante 35
148c23ae: posts the ante 35
62a1d8c0: posts the ante 35
d7c2f8c8: posts the ante 35
c0edb2ef: posts the ante 35
c0edb2ef: posts small blind 125
148c23ae: posts big blind 250
*** HOLE CARDS ***
Dealt to c0edb2ef 
Dealt to 148c23ae 
Dealt to 62a1d8c0 
Dealt to Hero [2d Qc]
Dealt to d7c2f8c8 
Dealt to 8638c512 
62a1d8c0: folds
Hero: folds
d7c2f8c8: folds
8638c512: folds
c0edb2ef: folds
Uncalled bet (125) returned to 148c23ae
*** SHOWDOWN ***
148c23ae collected 460 from pot
*** SUMMARY ***
Total pot 460 | Rake 0 | Jackpot 0 | Bingo 0 | Fortune 0 | Tax 0
Seat 1: c0edb2ef (small blind) folded before Flop
Seat 2: 148c23ae (big blind) collected (460)
Seat 3: 62a1d8c0 folded before Flop
Seat 4: Hero folded before Flop
Seat 5: d7c2f8c8 folded before Flop
Seat 6: 8638c512 (button) folded before Flop


Poker Hand #TM4180158087: Tournament #187165250, Mini Hypersonic $2.50 Hold'em No Limit - Level6(125/250) - 2025/02/03 16:11:43
Table '2' 6-max Seat #5 is the button
Seat 1: c0edb2ef (6,519 in chips)
Seat 2: 148c23ae (9,493 in chips)
Seat 3: 62a1d8c0 (8,893 in chips)
Seat 4: Hero (21,970 in chips)
Seat 5: d7c2f8c8 (7,200 in chips)
Seat 6: 8638c512 (21,805 in chips)
Hero: posts the ante 35
8638c512: posts the ante 35
148c23ae: posts the ante 35
62a1d8c0: posts the ante 35
d7c2f8c8: posts the ante 35
c0edb2ef: posts the ante 35
8638c512: posts small blind 125
c0edb2ef: posts big blind 250
*** HOLE CARDS ***
Dealt to c0edb2ef 
Dealt to 148c23ae 
Dealt to 62a1d8c0 
Dealt to Hero [Kd 6d]
Dealt to d7c2f8c8 
Dealt to 8638c512 
148c23ae: folds
62a1d8c0: folds
Hero: folds
d7c2f8c8: folds
8638c512: calls 125
c0edb2ef: checks
*** FLOP *** [Kh 9d 2s]
8638c512: bets 250
c0edb2ef: folds
Uncalled bet (250) returned to 8638c512
*** SHOWDOWN ***
8638c512 collected 710 from pot
*** SUMMARY ***
Total pot 710 | Rake 0 | Jackpot 0 | Bingo 0 | Fortune 0 | Tax 0
Board [Kh 9d 2s]
Seat 1: c0edb2ef (big blind) folded on the Flop
Seat 2: 148c23ae folded before Flop
Seat 3: 62a1d8c0 folded before Flop
Seat 4: Hero folded before Flop
Seat 5: d7c2f8c8 (button) folded before Flop
Seat 6: 8638c512 (small blind) won (710)


Poker Hand #TM4180158076: Tournament #187165250, Mini Hypersonic $2.50 Hold'em No Limit - Level6(125/250) - 2025/02/03 16:11:14
Table '2' 6-max Seat #4 is the button
Seat 1: c0edb2ef (6,554 in chips)
Seat 2: 148c23ae (9,528 in chips)
Seat 3: 62a1d8c0 (8,928 in chips)
Seat 4: Hero (22,005 in chips)
Seat 5: d7c2f8c8 (7,360 in chips)
Seat 6: 8638c512 (21,505 in chips)
Hero: posts the ante 35
8638c512: posts the ante 35
148c23ae: posts the ante 35
62a1d8c0: posts the ante 35
c0edb2ef: posts the ante 35
d7c2f8c8: posts the ante 35
d7c2f8c8: posts small blind 125
8638c512: posts big blind 250
*** HOLE CARDS ***
Dealt to c0edb2ef 
Dealt to 148c23ae 
Dealt to 62a1d8c0 
Dealt to Hero [Jd 9c]
Dealt to d7c2f8c8 
Dealt to 8638c512 
c0edb2ef: folds
148c23ae: folds
62a1d8c0: folds
Hero: folds
d7c2f8c8: folds
Uncalled bet (125) returned to 8638c512
*** SHOWDOWN ***
8638c512 collected 460 from pot
*** SUMMARY ***
Total pot 460 | Rake 0 | Jackpot 0 | Bingo 0 | Fortune 0 | Tax 0
Seat 1: c0edb2ef folded before Flop
Seat 2: 148c23ae folded before Flop
Seat 3: 62a1d8c0 folded before Flop
Seat 4: Hero (button) folded before Flop
Seat 5: d7c2f8c8 (small blind) folded before Flop
Seat 6: 8638c512 (big blind) collected (460)


Poker Hand #TM4180158055: Tournament #187165250, Mini Hypersonic $2.50 Hold'em No Limit - Level5(100/200) - 2025/02/03 16:10:01
Table '2' 6-max Seat #3 is the button
Seat 1: c0edb2ef (6,584 in chips)
Seat 2: 148c23ae (9,558 in chips)
Seat 3: 62a1d8c0 (8,958 in chips)
Seat 4: Hero (19,975 in chips)
Seat 5: d7c2f8c8 (7,830 in chips)
Seat 6: 8638c512 (22,975 in chips)
Hero: posts the ante 30
8638c512: posts the ante 30
148c23ae: posts the ante 30
62a1d8c0: posts the ante 30
c0edb2ef: posts the ante 30
d7c2f8c8: posts the ante 30
Hero: posts small blind 100
d7c2f8c8: posts big blind 200
*** HOLE CARDS ***
Dealt to c0edb2ef 
Dealt to 148c23ae 
Dealt to 62a1d8c0 
Dealt to Hero [6d 6s]
Dealt to d7c2f8c8 
Dealt to 8638c512 
8638c512: raises 240 to 440
c0edb2ef: folds
148c23ae: folds
62a1d8c0: folds
Hero: calls 340
d7c2f8c8: calls 240
*** FLOP *** [Jd 8h 6h]
Hero: checks
d7c2f8c8: checks
8638c512: checks
*** TURN *** [Jd 8h 6h] [Tc]
Hero: bets 1,000
d7c2f8c8: folds
8638c512: calls 1,000
*** RIVER *** [Jd 8h 6h Tc] [3h]
Hero: bets 1,750
8638c512: folds
Uncalled bet (1,750) returned to Hero
*** SHOWDOWN ***
Hero collected 3,500 from pot
*** SUMMARY ***
Total pot 3,500 | Rake 0 | Jackpot 0 | Bingo 0 | Fortune 0 | Tax 0
Board [Jd 8h 6h Tc 3h]
Seat 1: c0edb2ef folded before Flop
Seat 2: 148c23ae folded before Flop
Seat 3: 62a1d8c0 (button) folded before Flop
Seat 4: Hero (small blind) won (3,500)
Seat 5: d7c2f8c8 (big blind) folded on the Turn
Seat 6: 8638c512 folded on the River


Poker Hand #TM4180158045: Tournament #187165250, Mini Hypersonic $2.50 Hold'em No Limit - Level5(100/200) - 2025/02/03 16:09:15
Table '2' 6-max Seat #2 is the button
Seat 1: c0edb2ef (6,614 in chips)
Seat 2: 148c23ae (8,033 in chips)
Seat 3: 62a1d8c0 (9,088 in chips)
Seat 4: Hero (20,205 in chips)
Seat 6: 8638c512 (24,110 in chips)
Hero: posts the ante 30
8638c512: posts the ante 30
148c23ae: posts the ante 30
62a1d8c0: posts the ante 30
c0edb2ef: posts the ante 30
62a1d8c0: posts small blind 100
Hero: posts big blind 200
*** HOLE CARDS ***
Dealt to c0edb2ef 
Dealt to 148c23ae 
Dealt to 62a1d8c0 
Dealt to Hero [8c Qh]
Dealt to 8638c512 
8638c512: raises 240 to 440
c0edb2ef: folds
148c23ae: raises 665 to 1,105
62a1d8c0: folds
Hero: folds
8638c512: calls 665
*** FLOP *** [Td Js 6h]
8638c512: checks
148c23ae: bets 1,330
8638c512: folds
Uncalled bet (1,330) returned to 148c23ae
*** SHOWDOWN ***
148c23ae collected 2,660 from pot
*** SUMMARY ***
Total pot 2,660 | Rake 0 | Jackpot 0 | Bingo 0 | Fortune 0 | Tax 0
Board [Td Js 6h]
Seat 1: c0edb2ef folded before Flop
Seat 2: 148c23ae (button) won (2,660)
Seat 3: 62a1d8c0 (small blind) folded before Flop
Seat 4: Hero (big blind) folded before Flop
Seat 6: 8638c512 folded on the Flop


Poker Hand #TM4180158026: Tournament #187165250, Mini Hypersonic $2.50 Hold'em No Limit - Level5(100/200) - 2025/02/03 16:08:00
Table '2' 6-max Seat #1 is the button
Seat 1: c0edb2ef (6,644 in chips)
Seat 2: 148c23ae (8,163 in chips)
Seat 3: 62a1d8c0 (9,318 in chips)
Seat 4: Hero (20,235 in chips)
Seat 5: 8a4e9d6f (9,970 in chips)
Seat 6: 8638c512 (13,720 in chips)
8a4e9d6f: posts the ante 30
Hero: posts the ante 30
8638c512: posts the ante 30
148c23ae: posts the ante 30
62a1d8c0: posts the ante 30
c0edb2ef: posts the ante 30
148c23ae: posts small blind 100
62a1d8c0: posts big blind 200
*** HOLE CARDS ***
Dealt to c0edb2ef 
Dealt to 148c23ae 
Dealt to 62a1d8c0 
Dealt to Hero [2d 3c]
Dealt to 8a4e9d6f 
Dealt to 8638c512 
Hero: folds
8a4e9d6f: raises 220 to 420
8638c512: raises 990 to 1,410
c0edb2ef: folds
148c23ae: folds
62a1d8c0: folds
8a4e9d6f: calls 990
*** FLOP *** [9c Ts Ac]
8a4e9d6f: checks
8638c512: bets 2,178
8a4e9d6f: raises 6,352 to 8,530 and is all-in
8638c512: calls 6,352
8a4e9d6f: shows [Ad Qh] (Pair of Aces)
8638c512: shows [Th 9h] (Pair of Tens and Pair of Nines)
*** TURN *** [9c Ts Ac] [4c]
*** RIVER *** [9c Ts Ac 4c] [6h]
*** SHOWDOWN ***
8638c512 collected 20,360 from pot
*** SUMMARY ***
Total pot 20,360 | Rake 0 | Jackpot 0 | Bingo 0 | Fortune 0 | Tax 0
Board [9c Ts Ac 4c 6h]
Seat 1: c0edb2ef (button) folded before Flop
Seat 2: 148c23ae (small blind) folded before Flop
Seat 3: 62a1d8c0 (big blind) folded before Flop
Seat 4: Hero folded before Flop
Seat 5: 8a4e9d6f showed [Ad Qh] and lost with Pair of Aces
Seat 6: 8638c512 showed [Th 9h] and won (20,360) with Pair of Tens and Pair of Nines


Poker Hand #TM4180158020: Tournament #187165250, Mini Hypersonic $2.50 Hold'em No Limit - Level5(100/200) - 2025/02/03 16:07:43
Table '2' 6-max Seat #6 is the button
Seat 1: c0edb2ef (6,774 in chips)
Seat 2: 148c23ae (7,913 in chips)
Seat 3: 62a1d8c0 (9,348 in chips)
Seat 4: Hero (20,265 in chips)
Seat 5: 8a4e9d6f (10,000 in chips)
Seat 6: 8638c512 (13,750 in chips)
8a4e9d6f: posts the ante 30
Hero: posts the ante 30
8638c512: posts the ante 30
148c23ae: posts the ante 30
62a1d8c0: posts the ante 30
c0edb2ef: posts the ante 30
c0edb2ef: posts small blind 100
148c23ae: posts big blind 200
*** HOLE CARDS ***
Dealt to c0edb2ef 
Dealt to 148c23ae 
Dealt to 62a1d8c0 
Dealt to Hero [4s 8h]
Dealt to 8a4e9d6f 
Dealt to 8638c512 
62a1d8c0: folds
Hero: folds
8a4e9d6f: folds
8638c512: folds
c0edb2ef: folds
Uncalled bet (100) returned to 148c23ae
*** SHOWDOWN ***
148c23ae collected 380 from pot
*** SUMMARY ***
Total pot 380 | Rake 0 | Jackpot 0 | Bingo 0 | Fortune 0 | Tax 0
Seat 1: c0edb2ef (small blind) folded before Flop
Seat 2: 148c23ae (big blind) collected (380)
Seat 3: 62a1d8c0 folded before Flop
Seat 4: Hero folded before Flop
Seat 5: 8a4e9d6f folded before Flop
Seat 6: 8638c512 (button) folded before Flop


Poker Hand #TM4180158015: Tournament #187165250, Mini Hypersonic $2.50 Hold'em No Limit - Level4(80/160) - 2025/02/03 16:06:59
Table '2' 6-max Seat #4 is the button
Seat 1: c0edb2ef (6,274 in chips)
Seat 2: 148c23ae (7,938 in chips)
Seat 3: 62a1d8c0 (9,373 in chips)
Seat 4: Hero (20,290 in chips)
Seat 5: 8f27bbb9 (240 in chips)
Seat 6: 8638c512 (13,935 in chips)
Hero: posts the ante 25
8638c512: posts the ante 25
148c23ae: posts the ante 25
8f27bbb9: posts the ante 25
62a1d8c0: posts the ante 25
c0edb2ef: posts the ante 25
8f27bbb9: posts small blind 80
8638c512: posts big blind 160
*** HOLE CARDS ***
Dealt to c0edb2ef 
Dealt to 148c23ae 
Dealt to 62a1d8c0 
Dealt to Hero [7h 4c]
Dealt to 8f27bbb9 
Dealt to 8638c512 
c0edb2ef: raises 160 to 320
148c23ae: folds
62a1d8c0: folds
Hero: folds
8f27bbb9: calls 135 and is all-in
8638c512: folds
Uncalled bet (105) returned to c0edb2ef
c0edb2ef: shows [As 9s]
8f27bbb9: shows [9d 3c]
*** FLOP *** [7c 4h 5c]
*** TURN *** [7c 4h 5c] [Qs]
*** RIVER *** [7c 4h 5c Qs] [2h]
*** SHOWDOWN ***
c0edb2ef collected 740 from pot
*** SUMMARY ***
Total pot 740 | Rake 0 | Jackpot 0 | Bingo 0 | Fortune 0 | Tax 0
Board [7c 4h 5c Qs 2h]
Seat 1: c0edb2ef showed [As 9s] and won (740) with Ace-High
Seat 2: 148c23ae folded before Flop
Seat 3: 62a1d8c0 folded before Flop
Seat 4: Hero (button) folded before Flop
Seat 5: 8f27bbb9 (small blind) showed [9d 3c] and lost with Queen-High
Seat 6: 8638c512 (big blind) folded before Flop


Poker Hand #TM4180158004: Tournament #187165250, Mini Hypersonic $2.50 Hold'em No Limit - Level4(80/160) - 2025/02/03 16:06:27
Table '2' 6-max Seat #3 is the button
Seat 1: c0edb2ef (6,299 in chips)
Seat 2: 148c23ae (7,963 in chips)
Seat 3: 62a1d8c0 (9,398 in chips)
Seat 4: Hero (20,360 in chips)
Seat 5: 8f27bbb9 (70 in chips)
Seat 6: 8638c512 (13,960 in chips)
Hero: posts the ante 25
8638c512: posts the ante 25
148c23ae: posts the ante 25
8f27bbb9: posts the ante 25
62a1d8c0: posts the ante 25
c0edb2ef: posts the ante 25
Hero: posts small blind 80
8f27bbb9: posts big blind 45
*** HOLE CARDS ***
Dealt to c0edb2ef 
Dealt to 148c23ae 
Dealt to 62a1d8c0 
Dealt to Hero [4c 6c]
Dealt to 8f27bbb9 
Dealt to 8638c512 
8638c512: folds
c0edb2ef: folds
148c23ae: folds
62a1d8c0: folds
Uncalled bet (35) returned to Hero
Hero: shows [4c 6c]
8f27bbb9: shows [Qh 6d]
*** FLOP *** [Tc 7d 7s]
*** TURN *** [Tc 7d 7s] [9d]
*** RIVER *** [Tc 7d 7s 9d] [Th]
*** SHOWDOWN ***
8f27bbb9 collected 240 from pot
*** SUMMARY ***
Total pot 240 | Rake 0 | Jackpot 0 | Bingo 0 | Fortune 0 | Tax 0
Board [Tc 7d 7s 9d Th]
Seat 1: c0edb2ef folded before Flop
Seat 2: 148c23ae folded before Flop
Seat 3: 62a1d8c0 (button) folded before Flop
Seat 4: Hero (small blind) showed [4c 6c] and lost with Pair of Tens and Pair of Sevens
Seat 5: 8f27bbb9 (big blind) showed [Qh 6d] and won (240) with Pair of Tens and Pair of Sevens
Seat 6: 8638c512 folded before Flop


Poker Hand #TM4180157971: Tournament #187165250, Mini Hypersonic $2.50 Hold'em No Limit - Level4(80/160) - 2025/02/03 16:04:16
Table '2' 6-max Seat #2 is the button
Seat 1: c0edb2ef (6,644 in chips)
Seat 2: 148c23ae (7,988 in chips)
Seat 3: 62a1d8c0 (9,503 in chips)
Seat 4: Hero (9,930 in chips)
Seat 5: 8f27bbb9 (10,000 in chips)
Seat 6: 8638c512 (13,985 in chips)
Hero: posts the ante 25
8638c512: posts the ante 25
148c23ae: posts the ante 25
8f27bbb9: posts the ante 25
62a1d8c0: posts the ante 25
c0edb2ef: posts the ante 25
62a1d8c0: posts small blind 80
Hero: posts big blind 160
*** HOLE CARDS ***
Dealt to c0edb2ef 
Dealt to 148c23ae 
Dealt to 62a1d8c0 
Dealt to Hero [3c 4c]
Dealt to 8f27bbb9 
Dealt to 8638c512 
8f27bbb9: raises 160 to 320
8638c512: folds
c0edb2ef: calls 320
148c23ae: folds
62a1d8c0: folds
Hero: calls 160
*** FLOP *** [3d 4s Kc]
Hero: checks
8f27bbb9: bets 393
c0edb2ef: folds
Hero: raises 567 to 960
8f27bbb9: calls 567
*** TURN *** [3d 4s Kc] [Th]
Hero: bets 2,720
8f27bbb9: calls 2,720
*** RIVER *** [3d 4s Kc Th] [5h]
Hero: bets 5,905 and is all-in
8f27bbb9: calls 5,905
Hero: shows [3c 4c] (Pair of Fours and Pair of Treys)
8f27bbb9: shows [Jh Kh] (Pair of Kings)
*** SHOWDOWN ***
Hero collected 20,360 from pot
*** SUMMARY ***
Total pot 20,360 | Rake 0 | Jackpot 0 | Bingo 0 | Fortune 0 | Tax 0
Board [3d 4s Kc Th 5h]
Seat 1: c0edb2ef folded on the Flop
Seat 2: 148c23ae (button) folded before Flop
Seat 3: 62a1d8c0 (small blind) folded before Flop
Seat 4: Hero (big blind) showed [3c 4c] and won (20,360) with Pair of Fours and Pair of Treys
Seat 5: 8f27bbb9 showed [Jh Kh] and lost with Pair of Kings
Seat 6: 8638c512 folded before Flop


Poker Hand #TM4180157962: Tournament #187165250, Mini Hypersonic $2.50 Hold'em No Limit - Level4(80/160) - 2025/02/03 16:03:46
Table '2' 6-max Seat #1 is the button
Seat 1: c0edb2ef (6,669 in chips)
Seat 2: 148c23ae (8,093 in chips)
Seat 3: 62a1d8c0 (9,880 in chips)
Seat 4: Hero (9,955 in chips)
Seat 6: 8638c512 (13,453 in chips)
Hero: posts the ante 25
8638c512: posts the ante 25
148c23ae: posts the ante 25
62a1d8c0: posts the ante 25
c0edb2ef: posts the ante 25
148c23ae: posts small blind 80
62a1d8c0: posts big blind 160
*** HOLE CARDS ***
Dealt to c0edb2ef 
Dealt to 148c23ae 
Dealt to 62a1d8c0 
Dealt to Hero [3d 7s]
Dealt to 8638c512 
Hero: folds
8638c512: raises 192 to 352
c0edb2ef: folds
148c23ae: folds
62a1d8c0: calls 192
*** FLOP *** [9h 6s Jh]
62a1d8c0: checks
8638c512: bets 600
62a1d8c0: folds
Uncalled bet (600) returned to 8638c512
*** SHOWDOWN ***
8638c512 collected 909 from pot
*** SUMMARY ***
Total pot 909 | Rake 0 | Jackpot 0 | Bingo 0 | Fortune 0 | Tax 0
Board [9h 6s Jh]
Seat 1: c0edb2ef (button) folded before Flop
Seat 2: 148c23ae (small blind) folded before Flop
Seat 3: 62a1d8c0 (big blind) folded on the Flop
Seat 4: Hero folded before Flop
Seat 6: 8638c512 won (909)


Poker Hand #TM4180157953: Tournament #187165250, Mini Hypersonic $2.50 Hold'em No Limit - Level4(80/160) - 2025/02/03 16:03:17
Table '2' 6-max Seat #6 is the button
Seat 1: c0edb2ef (7,014 in chips)
Seat 2: 148c23ae (7,648 in chips)
Seat 3: 62a1d8c0 (9,905 in chips)
Seat 4: Hero (9,980 in chips)
Seat 5: f8250ce0 (13,339 in chips)
Seat 6: 8638c512 (13,478 in chips)
Hero: posts the ante 25
8638c512: posts the ante 25
f8250ce0: posts the ante 25
148c23ae: posts the ante 25
62a1d8c0: posts the ante 25
c0edb2ef: posts the ante 25
c0edb2ef: posts small blind 80
148c23ae: posts big blind 160
*** HOLE CARDS ***
Dealt to c0edb2ef 
Dealt to 148c23ae 
Dealt to 62a1d8c0 
Dealt to Hero [4h 9d]
Dealt to f8250ce0 
Dealt to 8638c512 
62a1d8c0: folds
Hero: folds
f8250ce0: folds
8638c512: folds
c0edb2ef: raises 160 to 320
148c23ae: raises 593 to 913
c0edb2ef: folds
Uncalled bet (593) returned to 148c23ae
*** SHOWDOWN ***
148c23ae collected 790 from pot
*** SUMMARY ***
Total pot 790 | Rake 0 | Jackpot 0 | Bingo 0 | Fortune 0 | Tax 0
Seat 1: c0edb2ef (small blind) folded before Flop
Seat 2: 148c23ae (big blind) collected (790)
Seat 3: 62a1d8c0 folded before Flop
Seat 4: Hero folded before Flop
Seat 5: f8250ce0 folded before Flop
Seat 6: 8638c512 (button) folded before Flop


Poker Hand #TM4180157928: Tournament #187165250, Mini Hypersonic $2.50 Hold'em No Limit - Level3(70/140) - 2025/02/03 16:01:10
Table '2' 6-max Seat #5 is the button
Seat 1: c0edb2ef (7,314 in chips)
Seat 2: 148c23ae (9,268 in chips)
Seat 3: 62a1d8c0 (9,925 in chips)
Seat 4: Hero (10,000 in chips)
Seat 5: f8250ce0 (11,289 in chips)
Seat 6: 8638c512 (13,568 in chips)
Hero: posts the ante 20
8638c512: posts the ante 20
f8250ce0: posts the ante 20
148c23ae: posts the ante 20
62a1d8c0: posts the ante 20
c0edb2ef: posts the ante 20
8638c512: posts small blind 70
c0edb2ef: posts big blind 140
*** HOLE CARDS ***
Dealt to c0edb2ef 
Dealt to 148c23ae 
Dealt to 62a1d8c0 
Dealt to Hero [Qh 7s]
Dealt to f8250ce0 
Dealt to 8638c512 
148c23ae: raises 140 to 280
62a1d8c0: folds
Hero: folds
f8250ce0: calls 280
8638c512: folds
c0edb2ef: calls 140
*** FLOP *** [3d 5s 4s]
c0edb2ef: checks
148c23ae: bets 340
f8250ce0: calls 340
c0edb2ef: folds
*** TURN *** [3d 5s 4s] [6d]
148c23ae: checks
f8250ce0: checks
*** RIVER *** [3d 5s 4s 6d] [Ac]
148c23ae: checks
f8250ce0: bets 980
148c23ae: calls 980
f8250ce0: shows [2c Kc] (Sixes-High Straight)
148c23ae: shows [Ts Ad] (Pair of Aces)
*** SHOWDOWN ***
f8250ce0 collected 3,670 from pot
*** SUMMARY ***
Total pot 3,670 | Rake 0 | Jackpot 0 | Bingo 0 | Fortune 0 | Tax 0
Board [3d 5s 4s 6d Ac]
Seat 1: c0edb2ef (big blind) folded on the Flop
Seat 2: 148c23ae showed [Ts Ad] and lost with Pair of Aces
Seat 3: 62a1d8c0 folded before Flop
Seat 4: Hero folded before Flop
Seat 5: f8250ce0 (button) showed [2c Kc] and won (3,670) with Sixes-High Straight
Seat 6: 8638c512 (small blind) folded before Flop